JOBID,SUBMITTED_AT,RUNNING_AT,FINISHED_AT,WAIT_DURATION,RUN_DURATION
1,1282733694,1282733707,1282733785,13,78
4,1282736899,1282736911,1282737239,12,328
6,1282738136,1282738141,1282738141,5,0
7,1282738434,1282738441,1282738568,7,127
8,1282739338,1282739342,1282740438,4,1096
10,1282739347,1282739356,1282740443,9,1087
9,1282739344,1282739356,1282740444,12,1088
14,1282741377,1282741381,1282741381,4,0
15,1282741525,1282741531,1282741543,6,12
16,1282741681,1282741696,1282741760,15,64
17,1282741898,1282741906,1282741912,8,6
18,1282741968,1282741997,1282742062,29,65
19,1282742085,1282742086,1282742705,1,619
20,1282742939,1282742941,1282742941,2,0
21,1282743054,1282743061,1282743061,7,0
25,1282752009,1282752017,1282752017,8,0
26,1282752009,1282752017,1282752017,8,0
27,1282752009,1282752017,1282752017,8,0
28,1282752010,1282752017,1282752017,7,0
29,1282752010,1282752017,1282752017,7,0
31,1282752010,1282752017,1282752017,7,0
34,1282752010,1282752017,1282752017,7,0
32,1282752010,1282752017,1282752017,7,0
33,1282752010,1282752017,1282752017,7,0
35,1282752010,1282752017,1282752017,7,0
37,1282752011,1282752017,1282752017,6,0
36,1282752010,1282752017,1282752017,7,0
41,1282752011,1282752017,1282752017,6,0
40,1282752011,1282752017,1282752017,6,0
39,1282752011,1282752017,1282752017,6,0
38,1282752011,1282752017,1282752017,6,0
44,1282752011,1282752017,1282752017,6,0
45,1282752011,1282752017,1282752017,6,0
43,1282752011,1282752017,1282752017,6,0
47,1282752012,1282752017,1282752017,5,0
50,1282752012,1282752017,1282752017,5,0
53,1282752012,1282752017,1282752017,5,0
51,1282752012,1282752017,1282752017,5,0
42,1282752011,1282752017,1282752017,6,0
49,1282752012,1282752017,1282752017,5,0
52,1282752012,1282752017,1282752017,5,0
46,1282752012,1282752017,1282752017,5,0
30,1282752010,1282752017,1282752017,7,0
48,1282752012,1282752017,1282752018,5,1
23,1282751803,1282751897,1282753075,94,1178
58,1282756228,1282756232,1282756525,4,293
61,1282757415,1282757417,1282757459,2,42
60,1282757412,1282757417,1282757472,5,55
59,1282757409,1282757417,1282757562,8,145
62,1282757515,1282757537,1282757665,22,128
63,1282757604,1282757612,1282757649,8,37
64,1282757706,1282757717,1282757814,11,97
69,1282759175,1282759187,1282759334,12,147
68,1282759162,1282759172,1282759418,10,246
73,1282759333,1282759337,1282759564,4,227
67,1282759147,1282759157,1282759593,10,436
79,1282761949,1282761992,1282762274,43,282
88,1282809712,1282809722,1282809727,10,5
94,1282810148,1282810157,1282810181,9,24
96,1282810410,1282810412,1282810457,2,45
80,1282762528,1282762532,1282814172,4,51640
78,1282759904,1282759907,1282815692,3,55785
70,1282759191,1282759202,1282815857,11,56655
86,1282809538,1282809542,1282820201,4,10659
98,1282810624,1282810637,1282827364,13,16727
97,1282810549,1282810562,1282828300,13,17738
95,1282810293,1282810307,1282835854,14,25547
91,1282809821,1282809827,1282836739,6,26912
104,1282811017,1282820417,1282842778,9400,22361
75,1282759551,1282759562,1282846227,11,86665
105,1282811071,1282827377,1282846298,16306,18921
109,1282811614,1282846247,1282849519,34633,3272
103,1282810969,1282815887,1282850306,4918,34419
108,1282811457,1282842812,1282850961,31355,8149
72,1282759317,1282759322,1282851921,5,92599
102,1282810918,1282815707,1282860673,4789,44966
101,1282810841,1282810847,1282863818,6,52971
110,1282811909,1282846337,1282869108,34428,22771
99,1282810792,1282810802,1282869677,10,58875
90,1282809778,1282809782,1282874565,4,64783
71,1282759226,1282759232,1282878714,6,119482
115,1282815521,1282849532,1282881165,34011,31633
76,1282759603,1282759607,1282883525,4,123918
112,1282815038,1282881182,1282885100,66144,3918
113,1282815205,1282883552,1282886538,68347,2986
127,1282826680,1282883552,1282886538,56872,2986
116,1282815704,1282850327,1282889149,34623,38822
119,1282819572,1282851933,1282890068,32361,38135
111,1282812254,1282881182,1282890101,68928,8919
128,1282827465,1282885144,1282890140,57679,4996
137,1282828663,1282890137,1282890140,61474,3
138,1282831941,1282890182,1282890422,58241,240
139,1282834056,1282890182,1282890422,56126,240
140,1282834123,1282890452,1282890609,56329,157
141,1282834395,1282890452,1282890609,56057,157
142,1282834401,1282890662,1282890937,56261,275
143,1282834515,1282890662,1282890937,56147,275
144,1282834521,1282890977,1282890980,56456,3
145,1282834683,1282890977,1282890980,56294,3
146,1282834692,1282891022,1282891319,56330,297
147,1282834796,1282891022,1282891319,56226,297
148,1282834805,1282891337,1282891340,56532,3
149,1282834937,1282891337,1282891340,56400,3
131,1282827855,1282889177,1282891641,61322,2464
132,1282828032,1282889177,1282891641,61145,2464
152,1282835132,1282891652,1282891655,56520,3
150,1282834982,1282891382,1282891750,56400,368
151,1282835126,1282891382,1282891750,56256,368
117,1282819203,1282850972,1282892856,31769,41884
134,1282828277,1282890092,1282894251,61815,4159
136,1282828549,1282890092,1282894251,61543,4159
129,1282827619,1282886582,1282895738,58963,9156
130,1282827825,1282886582,1282895738,58757,9156
156,1282893851,1282893857,1282896293,6,2436
157,1282893908,1282894292,1282898026,384,3734
158,1282893972,1282895747,1282899844,1775,4097
159,1282894046,1282896347,1282900135,2301,3788
160,1282894132,1282898057,1282901562,3925,3505
161,1282894290,1282899872,1282901742,5582,1870
124,1282825254,1282874582,1282902039,49328,27457
162,1282894387,1282900187,1282902282,5800,2095
92,1282809980,1282809992,1282905052,12,95060
167,1282895010,1282905092,1282905099,10082,7
168,1282895038,1282905137,1282905162,10099,25
169,1282895048,1282905182,1282905187,10134,5
170,1282895060,1282905212,1282905217,10152,5
171,1282895081,1282905257,1282905282,10176,25
164,1282894495,1282901792,1282905286,7297,3494
163,1282894446,1282901582,1282905312,7136,3730
172,1282895095,1282905302,1282905326,10207,24
173,1282895103,1282905302,1282905327,10199,25
174,1282895122,1282905332,1282905337,10210,5
175,1282895141,1282905332,1282905337,10191,5
166,1282894828,1282902302,1282906045,7474,3743
93,1282810068,1282810082,1282906127,14,96045
165,1282894766,1282902062,1282906618,7296,4556
100,1282810831,1282828367,1282908667,17536,80300
179,1282899469,1282905377,1282909084,5908,3707
210,1282909099,1282909112,1282909118,13,6
211,1282909099,1282909172,1282909177,73,5
212,1282909099,1282909217,1282909222,118,5
213,1282909099,1282909247,1282909252,148,5
214,1282909099,1282909292,1282909296,193,4
215,1282909099,1282909337,1282909342,238,5
216,1282909099,1282909367,1282909372,268,5
217,1282909099,1282909412,1282909417,313,5
218,1282909099,1282909457,1282909462,358,5
219,1282909099,1282909487,1282909492,388,5
220,1282909099,1282909532,1282909537,433,5
221,1282909099,1282909577,1282909584,478,7
222,1282909099,1282909607,1282909612,508,5
223,1282909099,1282909652,1282909657,553,5
224,1282909099,1282909697,1282909702,598,5
225,1282909099,1282909727,1282909732,628,5
226,1282909099,1282909772,1282909777,673,5
227,1282909099,1282909817,1282909822,718,5
228,1282909099,1282909847,1282909852,748,5
229,1282909099,1282909892,1282909897,793,5
230,1282909099,1282909937,1282909942,838,5
231,1282909099,1282909967,1282909972,868,5
232,1282909099,1282910012,1282910016,913,4
233,1282909099,1282910057,1282910062,958,5
234,1282909099,1282910087,1282910091,988,4
235,1282909099,1282910132,1282910137,1033,5
236,1282909099,1282910177,1282910181,1078,4
237,1282909099,1282910207,1282910212,1108,5
238,1282909099,1282910252,1282910258,1153,6
239,1282909099,1282910297,1282910303,1198,6
240,1282909099,1282910327,1282910334,1228,7
241,1282909099,1282910372,1282910376,1273,4
242,1282909099,1282910417,1282910424,1318,7
243,1282909099,1282910447,1282910452,1348,5
244,1282909099,1282910492,1282910499,1393,7
245,1282909099,1282910537,1282910543,1438,6
246,1282909100,1282910567,1282910573,1467,6
247,1282909100,1282910612,1282910623,1512,11
248,1282909100,1282910657,1282910661,1557,4
249,1282909100,1282910687,1282910695,1587,8
250,1282909100,1282910732,1282910740,1632,8
251,1282909100,1282910777,1282910781,1677,4
252,1282909100,1282910807,1282910813,1707,6
253,1282909100,1282910852,1282910857,1752,5
254,1282909118,1282910897,1282910903,1779,6
255,1282909118,1282910927,1282910932,1809,5
256,1282909118,1282910972,1282910977,1854,5
257,1282909118,1282911017,1282911022,1899,5
258,1282909118,1282911047,1282911052,1929,5
125,1282826092,1282878737,1282911069,52645,32332
122,1282822362,1282869212,1282911060,46850,41848
259,1282909118,1282911092,1282911096,1974,4
260,1282909118,1282911107,1282911113,1989,6
261,1282909118,1282911137,1282911142,2019,5
262,1282909118,1282911137,1282911142,2019,5
263,1282909118,1282911167,1282911172,2049,5
264,1282909118,1282911182,1282911187,2064,5
265,1282909118,1282911212,1282911219,2094,7
267,1282909118,1282911257,1282911262,2139,5
266,1282909118,1282911227,1282911252,2109,25
268,1282909118,1282911287,1282911292,2169,5
269,1282909118,1282911302,1282911307,2184,5
270,1282909118,1282911332,1282911337,2214,5
271,1282909118,1282911347,1282911352,2229,5
272,1282909118,1282911377,1282911382,2259,5
273,1282909118,1282911377,1282911383,2259,6
274,1282909118,1282911407,1282911412,2289,5
275,1282909118,1282911422,1282911427,2304,5
276,1282909118,1282911452,1282911477,2334,25
277,1282909118,1282911467,1282911472,2349,5
278,1282909118,1282911497,1282911502,2379,5
279,1282909118,1282911497,1282911502,2379,5
280,1282909118,1282911527,1282911532,2409,5
281,1282909118,1282911542,1282911547,2424,5
282,1282909118,1282911572,1282911578,2454,6
283,1282909118,1282911587,1282911593,2469,6
284,1282909118,1282911617,1282911623,2499,6
285,1282909118,1282911617,1282911622,2499,5
286,1282909118,1282911647,1282911654,2529,7
287,1282909118,1282911662,1282911667,2544,5
288,1282909118,1282911692,1282911699,2574,7
289,1282909118,1282911707,1282911713,2589,6
290,1282909118,1282911737,1282911743,2619,6
291,1282909118,1282911737,1282911749,2619,12
292,1282909118,1282911767,1282911772,2649,5
293,1282909118,1282911782,1282911791,2664,9
294,1282909118,1282911812,1282911819,2694,7
295,1282909118,1282911827,1282911832,2709,5
296,1282909118,1282911857,1282911863,2739,6
297,1282909118,1282911857,1282911863,2739,6
310,1282911523,1282911887,1282911888,364,1
311,1282911523,1282911887,1282911888,364,1
312,1282911523,1282911887,1282911888,364,1
313,1282911523,1282911887,1282911888,364,1
314,1282911523,1282911887,1282911888,364,1
315,1282911523,1282911887,1282911888,364,1
316,1282911523,1282911887,1282911888,364,1
320,1282911577,1282911887,1282911888,310,1
321,1282911577,1282911932,1282911933,355,1
322,1282911577,1282911932,1282911933,355,1
323,1282911577,1282911932,1282911933,355,1
324,1282911577,1282911932,1282911933,355,1
325,1282911577,1282911932,1282911933,355,1
326,1282911577,1282911932,1282911933,355,1
327,1282911577,1282911932,1282911933,355,1
191,1282900897,1282908737,1282912071,7840,3334
176,1282899049,1282911902,1282912605,12853,703
177,1282899206,1282911902,1282912605,12696,703
328,1282912504,1282912622,1282912627,118,5
186,1282900400,1282912667,1282913063,12267,396
187,1282900559,1282912667,1282913063,12108,396
123,1282822679,1282869722,1282914361,47043,44639
190,1282900830,1282908737,1282915212,7907,6475
330,1282912673,1282913102,1282915279,429,2177
192,1282900921,1282909097,1282915407,8176,6310
74,1282759459,1282759472,1282915500,13,156028
184,1282900092,1282912097,1282916368,12005,4271
185,1282900174,1282912097,1282916368,11923,4271
194,1282901019,1282916372,1282916726,15353,354
195,1282901095,1282916372,1282916726,15277,354
196,1282901180,1282916732,1282917019,15552,287
197,1282901204,1282916732,1282917019,15528,287
121,1282821734,1282863857,1282917133,42123,53276
198,1282901275,1282917062,1282917196,15787,134
199,1282901558,1282917062,1282917196,15504,134
337,1282913365,1282915412,1282917332,2047,1920
202,1282901918,1282917212,1282917654,15294,442
203,1282901945,1282917212,1282917654,15267,442
200,1282901641,1282917182,1282917782,15541,600
201,1282901683,1282917182,1282917782,15499,600
208,1282908802,1282917812,1282918028,9010,216
209,1282908845,1282917812,1282918028,8967,216
204,1282907830,1282917377,1282918049,9547,672
205,1282907858,1282917377,1282918049,9519,672
206,1282907970,1282917692,1282918152,9722,460
207,1282908759,1282917692,1282918152,8933,460
340,1282918233,1282918247,1282918248,14,1
341,1282918251,1282918262,1282918263,11,1
342,1282918281,1282918292,1282918296,11,4
343,1282918302,1282918307,1282918310,5,3
298,1282910112,1282918172,1282918581,8060,409
299,1282910172,1282918172,1282918581,8000,409
344,1282918951,1282918952,1282918956,1,4
345,1282918951,1282918952,1282918956,1,4
346,1282918951,1282918952,1282918956,1,4
347,1282918951,1282918952,1282918956,1,4
300,1282910220,1282918622,1282919036,8402,414
301,1282910312,1282918622,1282919036,8310,414
188,1282900646,1282915787,1282919119,15141,3332
189,1282900788,1282915787,1282919119,14999,3332
302,1282910390,1282919057,1282919526,8667,469
303,1282910551,1282919057,1282919526,8506,469
304,1282910612,1282919147,1282920294,8535,1147
305,1282911233,1282919147,1282920294,7914,1147
307,1282911357,1282919537,1282920687,8180,1150
308,1282911440,1282919537,1282920687,8097,1150
309,1282911464,1282920302,1282921049,8838,747
318,1282911555,1282920302,1282921049,8747,747
319,1282911559,1282920692,1282921317,9133,625
335,1282913193,1282920692,1282921317,7499,625
120,1282819904,1282860707,1282923265,40803,62558
193,1282900946,1282911092,1282923502,10146,12410
339,1282913484,1282921337,1282924684,7853,3347
334,1282913089,1282923542,1282924684,10453,1142
336,1282913321,1282921067,1282925737,7746,4670
338,1282913449,1282921067,1282925737,7618,4670
106,1282811133,1282835897,1282942425,24764,106528
183,1282900006,1282906652,1282942532,6646,35880
333,1282912935,1282915307,1282947527,2372,32220
331,1282912767,1282914407,1282952888,1640,38481
182,1282899859,1282906142,1282953340,6283,47198
181,1282899731,1282906067,1282954084,6336,48017
180,1282899577,1282905377,1282954725,5800,49348
332,1282912851,1282915247,1282956289,2396,41042
107,1282811227,1282836767,1282956373,25540,119606
89,1282809753,1282809767,1282967071,14,157304
66,1282758939,1282758947,1282979523,8,220576
178,1282899327,1282905347,1282982584,6020,77237
353,1282976444,1282976447,1283000289,3,23842
354,1282976448,1283000312,1283013780,23864,13468
352,1282976441,1282976447,1283024770,6,48323
355,1282976451,1283013827,1283039837,37376,26010
356,1282976469,1283024792,1283074837,48323,50045
348,1282931963,1282931972,1283092700,9,160728
83,1282809307,1282809317,1283106756,10,297439
154,1282893659,1282893662,1283135986,3,242324
329,1282912585,1282918052,1283165972,5467,247920
85,1282809391,1282809392,1283167315,1,357923
369,1283170062,1283170067,1283175779,5,5712
368,1283166290,1283166302,1283182644,12,16342
373,1283172240,1283182682,1283185025,10442,2343
366,1283165533,1283165537,1283186665,4,21128
374,1283172431,1283185067,1283187713,12636,2646
377,1283172977,1283187752,1283192658,14775,4906
375,1283172536,1283186717,1283193040,14181,6323
376,1283172833,1283186717,1283193321,13884,6604
365,1283165434,1283165447,1283194818,13,29371
379,1283173473,1283193077,1283195945,19604,2868
383,1283181685,1283195987,1283196284,14302,297
385,1283181884,1283196317,1283196840,14433,523
386,1283181927,1283196872,1283197272,14945,400
387,1283182008,1283197307,1283197752,15299,445
388,1283182969,1283197787,1283198120,14818,333
380,1283174067,1283193362,1283198428,19295,5066
389,1283183308,1283198147,1283198435,14839,288
382,1283174201,1283194832,1283198538,20631,3706
381,1283174127,1283194832,1283198692,20705,3860
390,1283183440,1283198447,1283198764,15007,317
391,1283183471,1283198477,1283198985,15006,508
359,1283155718,1283155727,1283203306,9,47579
378,1283173125,1283192672,1283205230,19547,12558
371,1283171988,1283175827,1283207647,3839,31820
349,1282975235,1282975247,1283214548,12,239301
370,1283171816,1283175827,1283222899,4011,47072
364,1283165074,1283165088,1283231215,14,66127
372,1283172185,1283182682,1283238295,10497,55613
367,1283166092,1283166108,1283258051,16,91943
397,1283270658,1283270672,1283270701,14,29
398,1283270692,1283270702,1283270709,10,7
399,1283270888,1283270897,1283270903,9,6
402,1283271289,1283271302,1283271439,13,137
395,1283252522,1283252537,1283282411,15,29874
351,1282975316,1282975322,1283282815,6,307493
393,1283251958,1283251967,1283283193,9,31226
357,1283152657,1283152667,1283312012,10,159345
396,1283252719,1283252732,1283313970,13,61238
363,1283159055,1283159057,1283318985,2,159928
403,1283328841,1283328842,1283328850,1,8
405,1283328887,1283328902,1283328970,15,68
407,1283329198,1283329202,1283329208,4,6
406,1283329188,1283329202,1283329361,14,159
410,1283329251,1283329262,1283329475,11,213
408,1283329213,1283329217,1283329500,4,283
409,1283329222,1283329232,1283329554,10,322
404,1283328853,1283328857,1283331362,4,2505
413,1283330721,1283330732,1283334922,11,4190
414,1283336703,1283336717,1283336728,14,11
412,1283330581,1283330582,1283336980,1,6398
418,1283343477,1283343482,1283345150,5,1668
360,1283158324,1283158337,1283345328,13,186991
421,1283345367,1283345372,1283351571,5,6199
442,1283355347,1283355362,1283355367,15,5
417,1283337097,1283337107,1283357619,10,20512
425,1283354206,1283357642,1283358206,3436,564
426,1283354316,1283358242,1283358986,3926,744
427,1283354349,1283359007,1283359729,4658,722
450,1283360021,1283360027,1283360253,6,226
428,1283354431,1283359757,1283360355,5326,598
429,1283354467,1283360402,1283360711,5935,309
430,1283354509,1283360717,1283361233,6208,516
431,1283354587,1283361287,1283362175,6700,888
432,1283354624,1283362202,1283362470,7578,268
84,1282809328,1282809332,1283362529,4,553197
433,1283354788,1283362487,1283363011,7699,524
434,1283354859,1283363042,1283363428,8183,386
435,1283354881,1283363447,1283363866,8566,419
436,1283354947,1283363882,1283364382,8935,500
437,1283354978,1283364407,1283364723,9429,316
438,1283355059,1283364767,1283365363,9708,596
411,1283330013,1283330268,1283365397,255,35129
441,1283355227,1283365442,1283365448,10215,6
439,1283355098,1283365397,1283365772,10299,375
440,1283355187,1283365442,1283366114,10255,672
444,1283355388,1283365802,1283366661,10414,859
443,1283355351,1283365472,1283367557,10121,2085
445,1283355475,1283366162,1283367654,10687,1492
422,1283349052,1283349063,1283367771,11,18708
448,1283355620,1283367677,1283368655,12057,978
449,1283355686,1283367962,1283368706,12276,744
446,1283355509,1283366687,1283369087,11178,2400
447,1283355543,1283367587,1283369151,12044,1564
419,1283343482,1283343497,1283378210,15,34713
392,1283234936,1283345373,1283394073,110437,48700
415,1283336771,1283336777,1283410492,6,73715
456,1283416546,1283416547,1283416553,1,6
420,1283343488,1283343497,1283416828,9,73331
458,1283418039,1283418047,1283418834,8,787
459,1283418117,1283418122,1283418910,5,788
460,1283418199,1283418212,1283418940,13,728
462,1283419561,1283419562,1283419586,1,24
461,1283418299,1283418842,1283419831,543,989
464,1283420081,1283420087,1283420708,6,621
465,1283420587,1283420597,1283421463,10,866
466,1283423028,1283423042,1283423046,14,4
454,1283410566,1283410577,1283422786,11,12209
469,1283424107,1283424122,1283424127,15,5
453,1283410561,1283410562,1283424056,1,13494
468,1283423932,1283423942,1283427005,10,3063
467,1283423814,1283423822,1283428142,8,4320
471,1283431412,1283431427,1283431747,15,320
473,1283431789,1283431802,1283431807,13,5
470,1283431300,1283431307,1283432600,7,1293
474,1283431901,1283431907,1283432955,6,1048
472,1283431447,1283431457,1283433533,10,2076
477,1283434420,1283434427,1283434975,7,548
457,1283416649,1283416653,1283435001,4,18348
480,1283434962,1283434967,1283434984,5,17
482,1283435550,1283435552,1283435574,2,22
451,1283410538,1283410547,1283438732,9,28185
484,1283435558,1283438747,1283438762,3189,15
452,1283410541,1283410547,1283441223,6,30676
485,1283443546,1283443547,1283443563,1,16
463,1283419718,1283419727,1283480590,9,60863
478,1283434464,1283434472,1283480811,8,46339
476,1283433356,1283435028,1283498008,1672,62980
500,1283499814,1283499827,1283501834,13,2007
501,1283503415,1283503428,1283503434,13,6
504,1283503992,1283503997,1283504317,5,320
503,1283503965,1283503967,1283504338,2,371
509,1283504305,1283504372,1283504376,67,4
510,1283504339,1283504417,1283504421,78,4
506,1283504070,1283504072,1283504570,2,498
505,1283504033,1283504042,1283504578,9,536
507,1283504108,1283504342,1283504602,234,260
508,1283504152,1283504447,1283504823,295,376
512,1283504560,1283504613,1283505444,53,831
511,1283504499,1283504613,1283505649,114,1036
515,1283506605,1283506607,1283506611,2,4
517,1283506895,1283506907,1283506911,12,4
516,1283506672,1283506682,1283507219,10,537
514,1283506434,1283506442,1283507423,8,981
513,1283506356,1283506367,1283507789,11,1422
518,1283507213,1283507823,1283507836,610,13
520,1283508072,1283508077,1283508080,5,3
521,1283512713,1283512728,1283512734,15,6
502,1283503825,1283503832,1283513869,7,10037
423,1283353150,1283353158,1283525662,8,172504
524,1283518948,1283525823,1283525857,6875,34
523,1283518861,1283518863,1283532965,2,14102
479,1283434496,1283480853,1283535175,46357,54322
486,1283496646,1283535227,1283535228,38581,1
487,1283496650,1283535257,1283535258,38607,1
488,1283496653,1283535302,1283535303,38649,1
475,1283432260,1283432267,1283535334,7,103067
489,1283496657,1283535347,1283535348,38690,1
490,1283496660,1283535377,1283535378,38717,1
491,1283496663,1283535422,1283535423,38759,1
492,1283496667,1283535467,1283535468,38800,1
493,1283496673,1283535497,1283535498,38824,1
494,1283496676,1283535542,1283535543,38866,1
495,1283496679,1283535587,1283535588,38908,1
496,1283496682,1283535617,1283535618,38935,1
497,1283496687,1283535662,1283535663,38975,1
498,1283496691,1283535707,1283535708,39016,1
499,1283496695,1283535737,1283535738,39042,1
519,1283507599,1283507612,1283542538,13,34926
522,1283518270,1283518279,1283549385,9,31106
483,1283435554,1283435612,1283570904,58,135292
526,1283590591,1283590592,1283590629,1,37
525,1283590312,1283590323,1283590797,11,474
530,1283593126,1283593127,1283593133,1,6
532,1283593669,1283593682,1283595502,13,1820
531,1283593636,1283593637,1283595563,1,1926
87,1282809595,1282809602,1283597516,7,787914
528,1283593044,1283593052,1283606052,8,13000
533,1283595966,1283595977,1283608964,11,12987
155,1282893747,1282893752,1283630776,5,737024
455,1283410681,1283410682,1283632042,1,221360
527,1283590690,1283590699,1283651548,9,60849
534,1283682928,1283682932,1283684968,4,2036
536,1283684949,1283684957,1283684957,8,0
550,1283685242,1283685257,1283685268,15,11
535,1283682989,1283682992,1283685696,3,2704
552,1283693478,1283693492,1283693497,14,5
554,1283693505,1283693507,1283693512,2,5
553,1283693495,1283693507,1283693512,12,5
555,1283693522,1283693537,1283693542,15,5
557,1283694465,1283694468,1283694475,3,7
559,1283694489,1283694497,1283694502,8,5
556,1283694457,1283694468,1283694473,11,5
558,1283694480,1283694482,1283694487,2,5
560,1283699558,1283699567,1283699572,9,5
561,1283700821,1283700827,1283700832,6,5
562,1283701843,1283701847,1283709880,4,8033
565,1283768587,1283768597,1283768600,10,3
566,1283768698,1283768703,1283768710,5,7
563,1283703868,1283703872,1283777244,4,73372
564,1283706368,1283706377,1283789779,9,83402
569,1283853784,1283853798,1283853831,14,33
570,1283856407,1283856422,1283856502,15,80
571,1283856860,1283856873,1283858596,13,1723
573,1283857995,1283857997,1283858791,2,794
575,1283859225,1283859227,1283859301,2,74
574,1283858598,1283858612,1283863534,14,4922
567,1283851317,1283851322,1283869788,5,18466
416,1283336883,1283336897,1283889063,14,552166
82,1282809173,1282809182,1283906238,9,1097056
572,1283856920,1283856932,1283912823,12,55891
568,1283851527,1283851532,1283914800,5,63268
577,1283933002,1283933012,1283933640,10,628
580,1283947922,1283947937,1283948487,15,550
582,1283955821,1283955828,1283956062,7,234
583,1283959873,1283959878,1283959949,5,71
586,1283960621,1283960885,1283960940,264,55
588,1283961311,1283961321,1283961384,10,63
589,1283961624,1283961636,1283961854,12,218
590,1283961624,1283961636,1283961783,12,147
592,1283961624,1283961636,1283961713,12,77
591,1283961624,1283961636,1283961713,12,77
593,1283961869,1283961933,1283962031,64,98
594,1283962477,1283962488,1283962495,11,7
595,1283962811,1283962818,1283962825,7,7
596,1283963123,1283963133,1283963141,10,8
597,1283963581,1283963584,1283964075,3,491
598,1283963628,1283963643,1283964218,15,575
599,1283964538,1283964801,1283965266,263,465
578,1283934325,1283934332,1283995504,7,61172
362,1283159050,1283159057,1284006526,7,847469
537,1283685170,1283685182,1284033945,12,348763
579,1283934696,1283934707,1284038010,11,103303
613,1284038310,1284038313,1284038319,3,6
614,1284038519,1284038523,1284038530,4,7
615,1284038592,1284038599,1284038606,7,7
618,1284040912,1284040923,1284040927,11,4
619,1284040949,1284040953,1284040968,4,15
621,1284041280,1284041358,1284041365,78,7
622,1284041354,1284041358,1284041364,4,6
623,1284041431,1284041433,1284041440,2,7
624,1284041505,1284041508,1284041514,3,6
625,1284041818,1284041823,1284042071,5,248
626,1284041855,1284041867,1284042149,12,282
627,1284041970,1284041973,1284042248,3,275
628,1284042085,1284042153,1284042400,68,247
629,1284042123,1284042212,1284042496,89,284
630,1284042162,1284042303,1284042576,141,273
631,1284042200,1284042468,1284042715,268,247
632,1284042238,1284042572,1284042856,334,284
633,1284042313,1284042632,1284042906,319,274
634,1284042387,1284042798,1284043047,411,249
636,1284042463,1284042947,1284043217,484,270
635,1284042425,1284042932,1284043216,507,284
637,1284042501,1284043113,1284043360,612,247
638,1284042538,1284043262,1284043535,724,273
639,1284042576,1284043292,1284043577,716,285
640,1284042654,1284043428,1284043676,774,248
641,1284042732,1284043592,1284043867,860,275
642,1284042769,1284043652,1284043935,883,283
643,1284042807,1284043758,1284044005,951,247
644,1284042882,1284043907,1284044177,1025,270
645,1284042919,1284044012,1284044296,1093,284
646,1284042994,1284044073,1284044320,1079,247
647,1284043032,1284044222,1284044500,1190,278
649,1284043107,1284044388,1284044636,1281,248
648,1284043069,1284044372,1284044656,1303,284
650,1284043145,1284044552,1284044827,1407,275
651,1284043257,1284044718,1284044966,1461,248
652,1284043295,1284044732,1284045016,1437,284
653,1284043412,1284044867,1284045142,1455,275
654,1284043451,1284045033,1284045282,1582,249
657,1284043841,1284045348,1284045353,1507,5
655,1284043489,1284045092,1284045378,1603,286
656,1284043527,1284045182,1284045455,1655,273
612,1284034135,1284034142,1284050544,7,16402
620,1284041022,1284041028,1284053469,6,12441
538,1283685175,1284033962,1284114568,348787,80606
424,1283353602,1283353608,1284176058,6,822450
672,1284200054,1284200084,1284200137,30,53
673,1284200352,1284200357,1284200384,5,27
674,1284200754,1284200762,1284200768,8,6
675,1284201126,1284201137,1284201185,11,48
687,1284213289,1284213302,1284214689,13,1387
684,1284213281,1284213287,1284214824,6,1537
685,1284213284,1284213287,1284214840,3,1553
678,1284213265,1284213272,1284215218,7,1946
680,1284213270,1284213272,1284215519,2,2247
681,1284213273,1284213287,1284215539,14,2252
682,1284213276,1284213287,1284215691,11,2404
683,1284213279,1284213287,1284215729,8,2442
686,1284213286,1284213287,1284216149,1,2862
677,1284213263,1284213272,1284216792,9,3520
679,1284213268,1284213272,1284217064,4,3792
689,1284213311,1284213317,1284218395,6,5078
676,1284213259,1284213289,1284219016,30,5727
688,1284213291,1284213302,1284219558,11,6256
704,1284277608,1284277622,1284277629,14,7
698,1284277468,1284277472,1284278210,4,738
696,1284277462,1284277472,1284278617,10,1145
701,1284277478,1284277487,1284278873,9,1386
699,1284277472,1284277487,1284279029,15,1542
692,1284277449,1284277457,1284279402,8,1945
697,1284277465,1284277472,1284279845,7,2373
700,1284277475,1284277487,1284280388,12,2901
702,1284277484,1284277487,1284280430,3,2943
691,1284277446,1284277457,1284280991,11,3534
694,1284277456,1284277457,1284282093,1,4636
695,1284277459,1284277472,1284282209,13,4737
690,1284277443,1284277459,1284282553,16,5094
703,1284277488,1284277502,1284282664,14,5162
693,1284277453,1284277457,1284285505,4,8048
706,1284362087,1284362102,1284362102,15,0
714,1284362112,1284362117,1284362850,5,733
715,1284362115,1284362117,1284362853,2,736
716,1284362118,1284362132,1284363506,14,1374
708,1284362093,1284362102,1284364050,9,1948
710,1284362100,1284362102,1284364284,2,2182
713,1284362109,1284362117,1284364501,8,2384
712,1284362106,1284362117,1284364499,11,2382
717,1284362121,1284362132,1284365027,11,2895
707,1284362091,1284362102,1284365636,11,3534
711,1284362103,1284362117,1284366678,14,4561
719,1284362127,1284362132,1284367297,5,5165
705,1284362082,1284362093,1284367832,11,5739
718,1284362124,1284362132,1284368227,8,6095
721,1284368897,1284368912,1284369567,15,655
709,1284362097,1284362102,1284370052,5,7950
723,1284383498,1284383509,1284383744,11,235
724,1284383502,1284383507,1284386366,5,2859
576,1283859427,1283859438,1284390705,11,531267
725,1284388954,1284388967,1284392612,13,3645
726,1284389112,1284389117,1284392868,5,3751
728,1284401174,1284401177,1284401213,3,36
727,1284401084,1284401088,1284403408,4,2320
730,1284401685,1284401687,1284415183,2,13496
732,1284401690,1284401702,1284418064,12,16362
729,1284401681,1284401687,1284423819,6,22132
731,1284401687,1284401702,1284428257,15,26555
735,1284402045,1284402047,1284439774,2,37727
720,1284362166,1284362177,1284448415,11,86238
733,1284401965,1284401972,1284450735,7,48763
736,1284451795,1284451802,1284451815,7,13
738,1284453071,1284453077,1284453457,6,380
742,1284457122,1284457127,1284457292,5,165
658,1284122150,1284122162,1284457379,12,335217
361,1283158689,1283203352,1284457456,44663,1254104
740,1284457115,1284457144,1284458709,29,1565
734,1284401973,1284401987,1284462525,14,60538
741,1284457119,1284457127,1284464384,8,7257
746,1284467222,1284467237,1284467237,15,0
747,1284467289,1284467297,1284469245,8,1948
751,1284469473,1284469488,1284469494,15,6
750,1284469363,1284469367,1284469647,4,280
600,1284033963,1284457487,1284469774,423524,12287
748,1284469356,1284469367,1284472161,11,2794
752,1284469615,1284469622,1284474228,7,4606
754,1284474744,1284474752,1284474768,8,16
749,1284469360,1284469367,1284477222,7,7855
744,1284463630,1284463637,1284481293,7,17656
759,1284486684,1284486692,1284492338,8,5646
760,1284486697,1284492362,1284492504,5665,142
743,1284463359,1284463367,1284497206,8,33839
753,1284471358,1284471363,1284498974,5,27611
745,1284467155,1284467162,1284522357,7,55195
758,1284475522,1284481367,1284525340,5845,43973
755,1284474784,1284474797,1284527752,13,52955
763,1284540406,1284540407,1284540413,1,6
766,1284541735,1284543663,1284543669,1928,6
767,1284542153,1284543782,1284544365,1629,583
660,1284138956,1284469818,1284546128,330862,76310
765,1284541195,1284541202,1284549994,7,8792
770,1284550351,1284550352,1284550359,1,7
775,1284552401,1284552407,1284552635,6,228
776,1284554790,1284554792,1284554792,2,0
779,1284555121,1284555122,1284555122,1,0
773,1284552297,1284552302,1284557560,5,5258
756,1284475100,1284475112,1284557963,12,82851
774,1284552341,1284557987,1284557995,5646,8
780,1284556421,1284558032,1284558039,1611,7
761,1284539837,1284539852,1284562171,15,22319
782,1284561113,1284561122,1284564243,9,3121
762,1284540241,1284540242,1284571048,1,30806
772,1284552195,1284552197,1284595157,2,42960
757,1284475329,1284477227,1284614160,1898,136933
81,1282809143,1282809153,1284618881,10,1809728
769,1284550229,1284550232,1284621394,3,71162
788,1284619534,1284621437,1284621598,1903,161
785,1284619522,1284619532,1284625352,10,5820
789,1284622926,1284622937,1284627283,11,4346
787,1284619530,1284619532,1284628258,2,8726
661,1284138963,1284547937,1284626975,408974,79038
781,1284556621,1284562232,1284629117,5611,66885
791,1284629296,1284629297,1284629322,1,25
792,1284629722,1284629732,1284629755,10,23
793,1284630200,1284630212,1284630235,12,23
794,1284630614,1284630617,1284630643,3,26
795,1284631083,1284631097,1284631119,14,22
796,1284631538,1284631547,1284631570,9,23
797,1284631962,1284631967,1284631990,5,23
798,1284632482,1284632492,1284632513,10,21
799,1284632960,1284632972,1284632997,12,25
800,1284633537,1284633542,1284633562,5,20
801,1284633989,1284633992,1284634017,3,25
802,1284634492,1284634502,1284634525,10,23
803,1284634993,1284634997,1284635020,4,23
790,1284623422,1284625382,1284634996,1960,9614
804,1284635516,1284635522,1284635547,6,25
805,1284636018,1284636032,1284636037,14,5
659,1284138952,1284458747,1284636821,319795,178074
784,1284619265,1284619277,1284641659,12,22382
809,1284644328,1284644342,1284644347,14,5
768,1284542644,1284543572,1284645002,928,101430
806,1284636461,1284636467,1284646402,6,9935
771,1284551681,1284551687,1284676410,6,124723
811,1284648969,1284648977,1284698576,8,49599
783,1284562726,1284571097,1284716188,8371,145091
764,1284540795,1284540797,1284776254,2,235457
816,1284796513,1284796517,1284797013,4,496
817,1284796520,1284796532,1284797959,12,1427
818,1284796523,1284796532,1284798570,9,2038
819,1284796526,1284796592,1284808810,66,12218
821,1284898832,1284898847,1284921720,15,22873
786,1284619527,1284619534,1284996197,7,376663
822,1284971473,1284971477,1285042573,4,71096
825,1285051091,1285051097,1285051421,6,324
663,1284138969,1284638987,1285065071,500018,426084
814,1284709367,1284709382,1285088817,15,379435
737,1284452476,1284452478,1285129990,2,677512
820,1284898602,1284898607,1285152440,5,253833
813,1284706283,1284706292,1285197196,9,490904
662,1284138966,1284628817,1285203592,489851,574775
827,1285233104,1285233108,1285237002,4,3894
829,1285235009,1285235012,1285239882,3,4870
832,1285235640,1285239962,1285239966,4322,4
831,1285235422,1285237022,1285240263,1600,3241
834,1285236464,1285240307,1285240311,3843,4
833,1285236386,1285240082,1285241413,3696,1331
828,1285233181,1285233182,1285241635,1,8453
837,1285239562,1285241687,1285241691,2125,4
835,1285238614,1285240352,1285242691,1738,2339
839,1285241728,1285242707,1285242711,979,4
830,1285235100,1285235102,1285242873,2,7771
840,1285241791,1285242752,1285243225,961,473
836,1285239334,1285241477,1285243418,2143,1941
838,1285241644,1285241717,1285243473,73,1756
841,1285242628,1285242917,1285243864,289,947
844,1285242837,1285243517,1285247651,680,4134
846,1285242940,1285247687,1285247691,4747,4
847,1285243195,1285247717,1285247722,4522,5
848,1285243258,1285247762,1285249303,4504,1541
849,1285243402,1285249367,1285251184,5965,1817
842,1285242676,1285243277,1285252344,601,9067
843,1285242793,1285243442,1285256436,649,12994
851,1285243499,1285252397,1285281151,8898,28754
665,1284138976,1285205507,1285284201,1066531,78694
826,1285153906,1285153909,1285298425,3,144516
864,1285250503,1285298463,1285302786,47960,4323
865,1285250716,1285302828,1285302860,52112,32
866,1285250823,1285302993,1285307796,52170,4803
867,1285250931,1285307868,1285307874,56937,6
868,1285251040,1285307943,1285307960,56903,17
870,1285251275,1285308183,1285308215,56908,32
871,1285251425,1285308423,1285308427,56998,4
854,1285244138,1285308512,1285308517,64374,5
856,1285244483,1285308542,1285308549,64059,7
857,1285247525,1285308587,1285308593,61062,6
858,1285247668,1285308632,1285308636,60964,4
859,1285249562,1285308662,1285308668,59100,6
860,1285249649,1285308707,1285308714,59058,7
861,1285249881,1285308752,1285308759,58871,7
862,1285249964,1285308782,1285308787,58818,5
863,1285250053,1285308827,1285308833,58774,6
869,1285251138,1285308872,1285308875,57734,3
872,1285252784,1285308902,1285308909,56118,7
873,1285252936,1285308947,1285308955,56011,8
874,1285253013,1285308992,1285308999,55979,7
875,1285253080,1285309022,1285309024,55942,2
855,1285244198,1285308512,1285315469,64314,6957
877,1285319843,1285319852,1285319876,9,24
878,1285320519,1285320527,1285320531,8,4
879,1285321344,1285321352,1285321358,8,6
880,1285322673,1285322687,1285322711,14,24
845,1285242901,1285243907,1285322749,1006,78842
881,1285322763,1285322777,1285322783,14,6
882,1285322871,1285322882,1285322886,11,4
884,1285330496,1285330502,1285330508,6,6
886,1285331600,1285331612,1285331616,12,4
887,1285331918,1285331927,1285331930,9,3
888,1285332319,1285332332,1285332336,13,4
921,1285335369,1285335467,1285335471,98,4
852,1285243545,1285256477,1285356177,12932,99700
850,1285243455,1285251242,1285363957,7787,112715
853,1285243577,1285281197,1285378218,37620,97021
885,1285331443,1285331447,1285428876,4,97429
815,1284709599,1284709607,1285487756,8,778149
824,1285051087,1285051097,1285514541,10,463444
986,1285335887,1285577642,1285577648,241755,6
1019,1285336433,1285577642,1285578298,241209,656
1020,1285336614,1285577642,1285580977,241028,3335
1025,1285580991,1285581002,1285581007,11,5
1027,1285581663,1285581678,1285584508,15,2830
1024,1285580961,1285580972,1285584601,11,3629
1026,1285581081,1285581092,1285584816,11,3724
883,1285323730,1285323739,1285587317,9,263578
1028,1285582055,1285587332,1285587335,5277,3
1029,1285582145,1285587362,1285587365,5217,3
1031,1285582187,1285587407,1285587411,5220,4
1023,1285580889,1285580897,1285587398,8,6501
1032,1285582238,1285587452,1285587455,5214,3
1033,1285582374,1285587482,1285587485,5108,3
1034,1285582388,1285587527,1285587532,5139,5
739,1284453317,1284453334,1285587658,17,1134324
1049,1285586928,1285587678,1285587703,750,25
1050,1285587283,1285587768,1285587777,485,9
1051,1285587555,1285587813,1285587819,258,6
1052,1285587612,1285587903,1285587911,291,8
1053,1285587689,1285587993,1285588027,304,34
1054,1285587834,1285588233,1285588238,399,5
1039,1285584004,1285588292,1285588295,4288,3
1030,1285582147,1285584542,1285588507,2395,3965
1042,1285585485,1285588547,1285588553,3062,6
1043,1285585825,1285588607,1285588613,2782,6
1022,1285579981,1285579982,1285591414,1,11432
1045,1285586499,1285591442,1285591465,4943,23
1046,1285586521,1285591532,1285591539,5011,7
1021,1285579910,1285579922,1285594440,12,14518
1048,1285586741,1285594472,1285594475,7731,3
1055,1285588368,1285594532,1285594535,6164,3
1038,1285583433,1285587468,1285595241,4035,7773
1058,1285603135,1285603142,1285603145,7,3
1056,1285598292,1285598297,1285606481,5,8184
1044,1285585963,1285588682,1285609585,2719,20903
1064,1285604025,1285609622,1285610195,5597,573
1059,1285603946,1285603952,1285612420,6,8468
1061,1285603975,1285603982,1285613838,7,9856
1063,1285604012,1285609622,1285617815,5610,8193
1062,1285604001,1285606517,1285621258,2516,14741
1035,1285582432,1285584677,1285621622,2245,36945
1060,1285603961,1285603967,1285622511,6,18544
1036,1285582678,1285584857,1285634361,2179,49504
1041,1285584450,1285588382,1285638413,3932,50031
1047,1285586637,1285591592,1285665248,4955,73656
1073,1285662793,1285665287,1285665861,2494,574
1068,1285662040,1285662047,1285666565,7,4518
1081,1285664328,1285666607,1285666749,2279,142
1082,1285664339,1285666772,1285667261,2433,489
1083,1285665006,1285667282,1285667764,2276,482
1070,1285662121,1285662122,1285669649,1,7527
1071,1285662324,1285662332,1285671490,8,9158
1065,1285660168,1285660172,1285677233,4,17061
1078,1285663242,1285677287,1285677292,14045,5
1069,1285662050,1285662062,1285677315,12,15253
1084,1285666169,1285667807,1285684146,1638,16339
1085,1285666729,1285677362,1285684214,10633,6852
1086,1285667409,1285684172,1285684578,16763,406
1087,1285667461,1285684247,1285684595,16786,348
1088,1285667559,1285684607,1285684741,17048,134
664,1284138972,1285067342,1285682679,928370,615337
1090,1285667698,1285684772,1285684917,17074,145
1072,1285662469,1285684967,1285685162,22498,195
1074,1285663008,1285665887,1285685496,2879,19609
1037,1285583014,1285587332,1285688396,4318,101064
1089,1285667566,1285684637,1285689640,17071,5003
1040,1285584033,1285588293,1285699100,4260,110807
1091,1285668348,1285688462,1285699244,20114,10782
1067,1285660331,1285660337,1285704088,6,43751
1092,1285668455,1285689677,1285705065,21222,15388
1066,1285660248,1285660262,1285708336,14,48074
1075,1285663125,1285669697,1285730331,6572,60634
1080,1285663390,1285685537,1285734393,22147,48856
1079,1285663277,1285677332,1285737241,14055,59909
1077,1285663226,1285671497,1285748788,8271,77291
1097,1285750044,1285750052,1285754756,8,4704
1096,1285742737,1285742747,1285757569,10,14822
666,1284138979,1285286027,1285775750,1147048,489723
667,1284138981,1285684847,1285775753,1545866,90906
1101,1285753256,1285754807,1285778089,1551,23282
1099,1285753111,1285753112,1285785207,1,32095
1100,1285753169,1285753173,1285788479,4,35306
1098,1285750303,1285750308,1285801763,5,51455
1110,1285754914,1285801833,1285801870,46919,37
1102,1285754103,1285757642,1285843187,3539,85545
1105,1285754432,1285785257,1285845369,30825,60112
1111,1285755007,1285802028,1285855666,47021,53638
1103,1285754175,1285778132,1285856215,23957,78083
669,1284138987,1285776857,1285865181,1637870,88324
1112,1285755017,1285855743,1285871758,100726,16015
1113,1285755061,1285871958,1285871989,116897,31
1114,1285755113,1285872153,1285872183,117040,30
1119,1285856045,1285872348,1285872379,16303,31
1106,1285754555,1285788512,1285875892,33957,87380
1115,1285761541,1285875962,1285896895,114421,20933
1116,1285775790,1285896917,1285897259,121127,342
1107,1285754693,1285843247,1285904925,88554,61678
1093,1285669160,1285699158,1285931681,29998,232523
1108,1285754797,1285845422,1285933172,90625,87750
1124,1285923591,1285933220,1285933248,9629,28
1125,1285923625,1285933503,1285933539,9878,36
1109,1285754878,1285856252,1285933841,101374,77589
1120,1285856364,1285872558,1285953394,16194,80836
670,1284138989,1285867472,1285955665,1728483,88193
1126,1285923653,1285933773,1285971976,10120,38203
358,1283153222,1283153237,1286042450,15,2889213
812,1284704015,1284704027,1286044930,12,1340903
671,1284138996,1285957952,1286047201,1818956,89249
807,1284636844,1286049482,1286095250,1412638,45768
808,1284636857,1286096403,1286096403,1459546,0
1122,1285914886,1285914887,1286121904,1,207017
1057,1285599492,1285599497,1286170278,5,570781
1130,1286179463,1286179472,1286181338,9,1866
810,1284647956,1286096432,1286192374,1448476,95942
1133,1286201597,1286201613,1286210699,16,9086
1128,1285932666,1285953468,1286244963,20802,291495
1131,1286201440,1286201447,1286244833,7,43386
1132,1286201537,1286201552,1286244833,15,43281
1134,1286201905,1286247167,1286247168,45262,1
1135,1286201909,1286247212,1286247303,45303,91
1138,1286261905,1286261912,1286261912,7,0
1095,1285742196,1285742207,1286270449,11,528242
1142,1286272723,1286272727,1286272750,4,23
1143,1286272729,1286272802,1286272816,73,14
1145,1286273467,1286273477,1286273521,10,44
1144,1286273461,1286273462,1286273505,1,43
1140,1286271551,1286271557,1286273927,6,2370
1146,1286275156,1286275157,1286275175,1,18
1147,1286275165,1286275172,1286275189,7,17
1148,1286275340,1286275352,1286275373,12,21
1149,1286275349,1286275352,1286275372,3,20
1150,1286275618,1286275622,1286275622,4,0
1151,1286275761,1286275772,1286275806,11,34
1152,1286275866,1286275877,1286275901,11,24
1153,1286276045,1286276057,1286276099,12,42
1141,1286271557,1286271572,1286277666,15,6094
1154,1286278663,1286278667,1286278667,4,0
1155,1286278677,1286278682,1286278682,5,0
1156,1286278799,1286278802,1286278823,3,21
1157,1286278802,1286278817,1286278828,15,11
1164,1286279801,1286279807,1286296686,6,16879
1163,1286279796,1286279807,1286300201,11,20394
1094,1285742078,1285742088,1286304363,10,562275
1162,1286279794,1286279807,1286309695,13,29888
1136,1286261849,1286261852,1286314228,3,52376
1137,1286261873,1286261882,1286314228,9,52346
1161,1286279791,1286279792,1286317403,1,37611
1165,1286279804,1286296697,1286320177,16893,23480
1158,1286279779,1286279792,1286334572,13,54780
1160,1286279788,1286279792,1286340892,4,61100
668,1284138984,1285775762,1286339689,1636778,563927
1166,1286279806,1286300207,1286347703,20401,47496
1174,1286349430,1286349437,1286349437,7,0
1171,1286349311,1286349317,1286352974,6,3657
1168,1286285268,1286304407,1286353226,19139,48819
1159,1286279785,1286279792,1286354838,7,75046
1175,1286349574,1286353007,1286355500,3433,2493
1139,1286262122,1286316617,1286355174,54495,38557
1176,1286349576,1286355527,1286357336,5951,1809
1184,1286355280,1286355737,1286358277,457,2540
1182,1286354899,1286358287,1286358311,3388,24
1167,1286285216,1286304407,1286366899,19191,62492
1186,1286358479,1286358482,1286370201,3,11719
1185,1286355331,1286357357,1286370873,2026,13516
1192,1286364620,1286370212,1286371146,5592,934
1191,1286364617,1286366927,1286372306,2310,5379
1193,1286364623,1286371172,1286373307,6549,2135
1195,1286364629,1286373332,1286373787,8703,455
1196,1286364632,1286373812,1286374209,9180,397
1194,1286364626,1286372327,1286374811,7701,2484
1198,1286366847,1286374847,1286374872,8000,25
1197,1286364635,1286374247,1286374854,9612,607
1199,1286367101,1286374892,1286376045,7791,1153
1181,1286354077,1286354852,1286382619,775,27767
1169,1286291562,1286340904,1286386629,49342,45725
1190,1286364606,1286364617,1286389837,11,25220
1203,1286388880,1286388887,1286391561,7,2674
1121,1285914229,1285914242,1286432505,13,518263
1170,1286291661,1286386698,1286433235,95037,46537
1204,1286440917,1286440924,1286443207,7,2283
1206,1286446451,1286446457,1286446568,6,111
1180,1286353889,1286433304,1286455814,79415,22510
1209,1286459744,1286459747,1286462545,3,2798
1202,1286388733,1286388737,1286466953,4,78216
1188,1286358562,1286469227,1286471110,110665,1883
1189,1286358590,1286471147,1286472959,112557,1812
1123,1285914896,1285914902,1286479542,6,564640
1214,1286467614,1286479577,1286489398,11963,9821
1208,1286448597,1286455877,1286493168,7280,37291
1216,1286468532,1286493227,1286503180,24695,9953
1215,1286468144,1286489417,1286512728,21273,23311
1217,1286529359,1286529362,1286534308,3,4946
1218,1286529903,1286534357,1286537664,4454,3307
1219,1286530632,1286537702,1286539431,7070,1729
1225,1286534919,1286539502,1286539578,4583,76
1223,1286534763,1286534777,1286541803,14,7026
1226,1286540937,1286542082,1286571505,1145,29423
1207,1286448256,1286448257,1286581496,1,133239
1205,1286442211,1286442212,1286628067,1,185855
1177,1286352567,1286352572,1286633976,5,281404
1179,1286353719,1286353727,1286653565,8,299838
1233,1286641084,1286641097,1286661264,13,20167
1200,1286388629,1286472977,1286694293,84348,221316
1211,1286460406,1286462567,1286726093,2161,263526
1210,1286460260,1286460272,1286838217,12,377945
1129,1285937271,1285937282,1286853417,11,916135
1178,1286352575,1286352587,1286866177,12,513590
1235,1286877128,1286877138,1286884040,10,6902
1234,1286875866,1286875879,1286886320,13,10441
1187,1286358509,1286370917,1286886837,12408,515920
1236,1286877350,1286884113,1286889251,6763,5138
1241,1286882998,1286883002,1286898346,4,15344
1244,1286883082,1286889303,1286905512,6221,16209
1245,1286883642,1286905713,1286905744,22071,31
1237,1286877588,1286886378,1286906566,8790,20188
1247,1286884450,1286906613,1286906619,22163,6
1253,1286890657,1286906657,1286907163,16000,506
1249,1286888642,1286907212,1286907218,18570,6
1254,1286890665,1286906657,1286907251,15992,594
1252,1286890040,1286906657,1286907623,16617,966
1248,1286888594,1286907212,1286908024,18618,812
1201,1286388633,1286694317,1286908867,305684,214550
1251,1286890033,1286906657,1286909515,16624,2858
1221,1286534465,1286908892,1286910774,374427,1882
1222,1286534504,1286910812,1286912623,376308,1811
1242,1286883065,1286892782,1286926803,9717,34021
1243,1286883070,1286892797,1286927786,9727,34989
1220,1286534429,1286888507,1286961252,354078,72745
1229,1286612261,1286963042,1286968699,350781,5657
1230,1286612275,1286968712,1286971858,356437,3146
1261,1286975868,1286975882,1286976315,14,433
1260,1286969992,1286970002,1286977417,10,7415
1246,1286883741,1286905908,1286982460,22167,76552
1262,1286983386,1286983397,1286983630,11,233
1263,1286984280,1286984282,1286984499,2,217
1264,1286984299,1286984522,1286990467,223,5945
1267,1286986165,1286990522,1286990729,4357,207
1268,1286986447,1286990762,1286997211,4315,6449
1269,1286986658,1286997242,1287001781,10584,4539
1266,1286985394,1287001802,1287001807,16408,5
1240,1286882265,1286892632,1287004528,10367,111896
1270,1287052197,1287052202,1287052209,5,7
1271,1287052375,1287052382,1287053091,7,709
1228,1286558475,1286912657,1287055704,354182,143047
1255,1286952815,1286971877,1287064566,19062,92689
1276,1287066154,1287066167,1287073122,13,6955
1256,1286952853,1287055742,1287115530,102889,59788
1257,1286953238,1287064592,1287123780,111354,59188
1272,1287055320,1287115547,1287162898,60227,47351
1273,1287055395,1287123797,1287183057,68402,59260
1117,1285851831,1285896917,1287253780,45086,1356863
1239,1286882260,1286892362,1287273507,10102,381145
551,1283685348,1283685737,1287359099,389,3673362
1277,1287121216,1287162902,1287382125,41686,219223
1274,1287060395,1287060407,1287390879,12,330472
1275,1287060399,1287060407,1287408815,8,348408
1283,1287405761,1287405768,1287410999,7,5231
1285,1287411604,1287411617,1287423567,13,11950
1286,1287413049,1287420362,1287423850,7313,3488
1288,1287422770,1287423887,1287424454,1117,567
1289,1287423254,1287424487,1287424806,1233,319
1290,1287426339,1287426347,1287426402,8,55
1291,1287426448,1287426452,1287426477,4,25
1287,1287422343,1287423617,1287426510,1274,2893
1292,1287426474,1287426527,1287435163,53,8636
1279,1287121322,1287382157,1287465815,260835,83658
1282,1287402155,1287402167,1287468088,12,65921
1295,1287473249,1287473252,1287473591,3,339
1296,1287473342,1287473612,1287474153,270,541
1297,1287473478,1287474212,1287474347,734,135
1293,1287472847,1287472862,1287477975,15,5113
1299,1287476060,1287478022,1287479900,1962,1878
1301,1287476392,1287476402,1287490452,10,14050
1302,1287476399,1287476402,1287492286,3,15884
1118,1285856003,1286121952,1287502831,265949,1380879
1238,1286881908,1286982530,1287502836,100622,520306
1305,1287485592,1287502847,1287502953,17255,106
1304,1287481768,1287502847,1287514174,21079,11327
1306,1287502781,1287502787,1287562027,6,59240
1303,1287481721,1287481727,1287578381,6,96654
1308,1287565422,1287565427,1287579765,5,14338
1309,1287565494,1287565502,1287580240,8,14738
1316,1287582777,1287582783,1287582788,6,5
1319,1287583863,1287583877,1287583881,14,4
1320,1287583885,1287583892,1287583896,7,4
1324,1287584518,1287584522,1287584526,4,4
1323,1287584513,1287584522,1287584526,9,4
1328,1287584830,1287584837,1287584841,7,4
1227,1286544756,1286571527,1287586153,26771,1014626
1281,1287387359,1287387362,1287594818,3,207456
1314,1287570561,1287570572,1287603263,11,32691
1313,1287570558,1287570572,1287636394,14,65822
1311,1287570550,1287570557,1287636600,7,66043
1340,1287651053,1287651062,1287651305,9,243
1341,1287651060,1287651347,1287651640,287,293
1342,1287652101,1287652112,1287652505,11,393
153,1282892139,1282892147,1287654338,8,4762191
1284,1287407130,1287407132,1287654655,2,247523
1343,1287654243,1287654257,1287656569,14,2312
1330,1287641199,1287641207,1287661571,8,20364
1344,1287674559,1287674567,1287682692,8,8125
1315,1287570566,1287570572,1287685294,6,114722
1333,1287647389,1287647402,1287685395,13,37993
1310,1287570547,1287570557,1287697370,10,126813
1294,1287473146,1287473147,1287698401,1,225254
1345,1287717129,1287717137,1287717224,8,87
1346,1287717221,1287717227,1287718299,6,1072
1338,1287649505,1287649517,1287721062,12,71545
1347,1287717229,1287717242,1287721856,13,4614
1348,1287725679,1287725687,1287725695,8,8
1298,1287473828,1287474377,1287729971,549,255594
1300,1287476099,1287654362,1287750854,178263,96492
1349,1287725956,1287725957,1287789181,1,63224
1336,1287647768,1287753767,1287858846,105999,105079
1355,1287904122,1287904127,1287905253,5,1126
1278,1287121263,1287183077,1287905408,61814,722331
1352,1287904063,1287904067,1287906555,4,2488
1353,1287904069,1287904082,1287906916,13,2834
1356,1287904128,1287905297,1287921035,1169,15738
1354,1287904101,1287904112,1287927265,11,23153
1337,1287647809,1287858857,1287963164,211048,104307
1331,1287647330,1287647343,1287993298,13,345955
1332,1287647384,1287647387,1288013403,3,366016
1359,1287999499,1287999512,1288013872,13,14360
1363,1288012993,1288012997,1288033591,4,20594
1366,1288013006,1288034147,1288055265,21141,21118
1351,1287819471,1287963197,1288059451,143726,96254
1361,1288012979,1288012982,1288074946,3,61964
1364,1288012997,1288013012,1288074946,15,61934
1362,1288012988,1288012997,1288074946,9,61949
1367,1288013011,1288055792,1288074946,42781,19154
1365,1288013002,1288013552,1288092811,550,79259
1376,1288076089,1288076102,1288125265,13,49163
1327,1287584820,1287584822,1288139993,2,555171
1375,1288076083,1288076087,1288144038,4,67951
1374,1288076077,1288076087,1288144694,10,68607
1326,1287584696,1287584702,1288145925,6,561223
1325,1287584639,1287584642,1288146272,3,561630
1360,1288000793,1288062392,1288169965,61599,107573
1312,1287570555,1287570557,1288181031,2,610474
1378,1288182258,1288182272,1288182306,14,34
1377,1288182249,1288182257,1288182314,8,57
1379,1288182637,1288182647,1288182726,10,79
1380,1288182644,1288182647,1288182687,3,40
1381,1288183094,1288183097,1288183173,3,76
1382,1288183107,1288183112,1288183230,5,118
1383,1288183223,1288183232,1288183284,9,52
1384,1288183323,1288183337,1288183432,14,95
1385,1288183507,1288183517,1288183587,10,70
1386,1288183522,1288183532,1288183669,10,137
1387,1288183781,1288183787,1288183824,6,37
1388,1288184179,1288184192,1288184244,13,52
1389,1288184184,1288184192,1288184293,8,101
1391,1288184342,1288184357,1288184459,15,102
1390,1288184339,1288184342,1288184502,3,160
1404,1288187747,1288187762,1288192689,15,4927
1405,1288187750,1288187762,1288192846,12,5084
1396,1288187665,1288187672,1288224873,7,37201
1321,1287584498,1287584507,1288237258,9,652751
1410,1288250310,1288250312,1288250364,2,52
1411,1288250313,1288250327,1288250379,14,52
1409,1288191949,1288191962,1288251126,13,59164
1414,1288250988,1288251002,1288253777,14,2775
1415,1288250991,1288251002,1288256924,11,5922
1397,1288187668,1288224887,1288258107,37219,33220
1417,1288261014,1288261022,1288261844,8,822
1318,1287583859,1287583862,1288265439,3,681577
1335,1287647583,1287647597,1288269310,14,621713
1334,1287647498,1287905448,1288286579,257950,381131
1398,1288187709,1288258142,1288290746,70433,32604
1317,1287583848,1287583862,1288307983,14,724121
1399,1288187712,1288290782,1288313876,103070,23094
1400,1288187721,1288313897,1288341684,126176,27787
1418,1288341935,1288341947,1288341954,12,7
1420,1288344305,1288344317,1288344429,12,112
1419,1288344302,1288344317,1288344529,15,212
1422,1288351650,1288351653,1288351657,3,4
1426,1288351772,1288351787,1288351791,15,4
1427,1288351945,1288351952,1288351956,7,4
1416,1288251206,1288251212,1288353787,6,102575
1421,1288344515,1288344527,1288357395,12,12868
1392,1288186891,1288287137,1288360028,100246,72891
1401,1288187724,1288341707,1288365117,153983,23410
1402,1288187736,1288365137,1288432796,177401,67659
1224,1286534799,1286539502,1288449448,4703,1909946
1429,1288431206,1288431212,1288451706,6,20494
1258,1286953437,1286953442,1288495933,5,1542491
1403,1288187738,1288432832,1288502372,245094,69540
1433,1288529442,1288529447,1288539332,5,9885
1434,1288596605,1288596617,1288603110,12,6493
1440,1288631538,1288631552,1288631557,14,5
1441,1288631939,1288631942,1288631947,3,5
1442,1288632147,1288632152,1288632156,5,4
1307,1287502812,1287502848,1288633267,36,1130419
1439,1288623893,1288623902,1288634160,9,10258
1443,1288683769,1288683782,1288683825,13,43
1444,1288683993,1288684007,1288684007,14,0
1445,1288684019,1288684022,1288684022,3,0
1438,1288623789,1288623798,1288684755,9,60957
1449,1288685118,1288685132,1288688051,14,2919
1447,1288684812,1288684817,1288698332,5,13515
1448,1288685028,1288685042,1288703811,14,18769
1451,1288709573,1288709582,1288709588,9,6
1452,1288709585,1288709597,1288709603,12,6
1453,1288709667,1288709672,1288709678,5,6
1454,1288709669,1288709672,1288709678,3,6
1455,1288709959,1288709972,1288710019,13,47
1457,1288709965,1288709972,1288710027,7,55
1456,1288709962,1288709972,1288710021,10,49
1458,1288709968,1288709972,1288710021,4,49
1446,1288684809,1288684817,1288712922,8,28105
1461,1288772403,1288772417,1288772436,14,19
1464,1288785653,1288785662,1288785669,9,7
1465,1288794342,1288794347,1288794367,5,20
1466,1288794351,1288794362,1288794397,11,35
1393,1288186972,1288362107,1288796949,175135,434842
1468,1288806295,1288806304,1288806352,9,48
1469,1288807413,1288807427,1288807509,14,82
1470,1288807988,1288807997,1288808051,9,54
1467,1288797653,1288797662,1288828918,9,31256
1460,1288772206,1288772207,1288839914,1,67707
1473,1288863920,1288863932,1288864365,12,433
1472,1288862801,1288862807,1288883234,6,20427
1394,1288186999,1288797767,1288924171,610768,126404
1459,1288772014,1288772027,1288945956,13,173929
1474,1288948584,1288948592,1288948667,8,75
1475,1288951165,1288951172,1288951419,7,247
1476,1288951265,1288951277,1288952009,12,732
1471,1288862381,1288862387,1288953875,6,91488
1477,1288954305,1288954307,1288954407,2,100
1478,1288954379,1288954382,1288954521,3,139
1483,1288956645,1288956647,1288956733,2,86
1482,1288956416,1288956424,1288966031,8,9607
1486,1288968063,1288968077,1288968082,14,5
1487,1288968083,1288968092,1288968097,9,5
1488,1288977759,1288977767,1288977772,8,5
1450,1288688157,1288688162,1289040128,5,351966
1489,1288977766,1288977767,1289090523,1,112756
1490,1289132757,1289132762,1289132766,5,4
1491,1289132766,1289132777,1289132781,11,4
1492,1289132772,1289132777,1289132781,5,4
1493,1289132776,1289132777,1289132781,1,4
1494,1289132780,1289132792,1289132796,12,4
1495,1289132785,1289132792,1289132796,7,4
1496,1289132790,1289132792,1289132796,2,4
1500,1289132808,1289132822,1289132827,14,5
1501,1289132812,1289132822,1289132831,10,9
1502,1289132820,1289132822,1289132827,2,5
1497,1289132794,1289132807,1289132811,13,4
1498,1289132800,1289132807,1289132811,7,4
1499,1289132805,1289132807,1289132811,2,4
1503,1289132822,1289132837,1289132841,15,4
1504,1289132826,1289132837,1289132841,11,4
1505,1289132831,1289132837,1289132841,6,4
1506,1289132834,1289132837,1289132841,3,4
1513,1289132856,1289132867,1289132871,11,4
1514,1289132860,1289132867,1289132871,7,4
1515,1289132863,1289132867,1289132871,4,4
1516,1289132865,1289132867,1289132871,2,4
1507,1289132837,1289132852,1289132856,15,4
1508,1289132840,1289132852,1289132856,12,4
1509,1289132844,1289132852,1289132856,8,4
1510,1289132846,1289132852,1289132856,6,4
1511,1289132849,1289132852,1289132857,3,5
1512,1289132851,1289132852,1289132855,1,3
1520,1289132882,1289132897,1289132905,15,8
1521,1289132886,1289132897,1289132903,11,6
1522,1289132900,1289132912,1289132921,12,9
1523,1289132904,1289132912,1289132917,8,5
1524,1289132910,1289132912,1289132920,2,8
1529,1289132931,1289132942,1289132953,11,11
1530,1289132934,1289132942,1289132956,8,14
1531,1289132940,1289132942,1289132954,2,12
1533,1289132948,1289132957,1289132961,9,4
1525,1289132913,1289132927,1289132934,14,7
1526,1289132916,1289132927,1289132932,11,5
1527,1289132920,1289132927,1289132944,7,17
1528,1289132923,1289132927,1289132934,4,7
1517,1289132868,1289132972,1289132976,104,4
1518,1289132871,1289132972,1289132977,101,5
1519,1289132877,1289132972,1289132979,95,7
1532,1289132944,1289133002,1289133005,58,3
1485,1288957478,1288957487,1289148670,9,191183
1534,1289210957,1289210972,1289210998,15,26
1539,1289212655,1289212667,1289212692,12,25
1540,1289212813,1289212817,1289212842,4,25
1541,1289212828,1289212832,1289212837,4,5
1542,1289213063,1289213072,1289213097,9,25
1544,1289213207,1289213222,1289214306,15,1084
1537,1289211457,1289211467,1289223570,10,12103
1545,1289235377,1289235392,1289242520,15,7128
1547,1289251672,1289251682,1289251932,10,250
1548,1289251750,1289251757,1289252000,7,243
1549,1289251907,1289251922,1289252179,15,257
1550,1289251910,1289251922,1289252224,12,302
1551,1289252889,1289252897,1289254912,8,2015
1280,1287221765,1287468077,1289261236,246312,1793159
1546,1289239078,1289239082,1289263286,4,24204
1552,1289285946,1289285957,1289285979,11,22
1553,1289285954,1289285957,1289285969,3,12
1554,1289286744,1289286752,1289286763,8,11
1555,1289287445,1289287457,1289287457,12,0
1556,1289287863,1289287877,1289287948,14,71
1557,1289288135,1289288147,1289288174,12,27
1558,1289288220,1289288222,1289288228,2,6
1559,1289288448,1289288462,1289288484,14,22
1561,1289289236,1289289242,1289289248,6,6
1560,1289288659,1289288672,1289290749,13,2077
1562,1289290765,1289290772,1289291051,7,279
1563,1289291724,1289291732,1289291775,8,43
1480,1288956278,1288956287,1289302595,9,346308
1535,1289211066,1289211077,1289324653,11,113576
1322,1287584505,1287584507,1289333528,2,1749021
1430,1288431484,1289261282,1289345132,829798,83850
1479,1288956253,1288956257,1289357423,4,401166
1564,1289292337,1289292347,1289364606,10,72259
1565,1289397906,1289397917,1289397925,11,8
1350,1287819387,1287819392,1289397983,5,1578591
1566,1289398062,1289398067,1289398075,5,8
1567,1289398078,1289398082,1289487859,4,89777
1538,1289211503,1289211512,1289489557,9,278045
1573,1289491509,1289491517,1289491596,8,79
1574,1289491524,1289491532,1289491611,8,79
1571,1289491487,1289491502,1289491801,15,299
1572,1289491496,1289491502,1289491786,6,284
1575,1289556655,1289556662,1289556741,7,79
1576,1289558694,1289558702,1289558731,8,29
1435,1288596754,1289347562,1289559101,750808,211539
823,1285051084,1285051099,1289559166,15,4508067
1577,1289558815,1289558822,1289562706,7,3884
1580,1289565406,1289565407,1289565407,1,0
1581,1289565537,1289565542,1289565544,5,2
1582,1289565605,1289565617,1289565619,12,2
1586,1289565606,1289565617,1289565625,11,8
1587,1289565606,1289565617,1289565626,11,9
1592,1289565606,1289565617,1289565639,11,22
1588,1289565606,1289565618,1289565627,12,9
1589,1289565606,1289565617,1289565625,11,8
1596,1289565606,1289565632,1289565634,26,2
1585,1289565606,1289565617,1289565626,11,9
1590,1289565606,1289565617,1289565626,11,9
1591,1289565606,1289565617,1289565631,11,14
1584,1289565606,1289565617,1289565650,11,33
1593,1289565606,1289565617,1289565629,11,12
1595,1289565606,1289565617,1289565627,11,10
1594,1289565606,1289565617,1289565626,11,9
1583,1289565605,1289565617,1289565626,12,9
1597,1289565606,1289565662,1289565663,56,1
1599,1289565606,1289565677,1289565683,71,6
1600,1289565606,1289565677,1289565682,71,5
1601,1289565606,1289565677,1289565680,71,3
1598,1289565606,1289565677,1289565682,71,5
1602,1289568406,1289568407,1289568489,1,82
1603,1289569230,1289569232,1289569308,2,76
1604,1289569570,1289569577,1289569652,7,75
1605,1289570407,1289570417,1289570502,10,85
1606,1289570664,1289570672,1289570757,8,85
1607,1289571012,1289571017,1289571102,5,85
1608,1289571327,1289571332,1289571417,5,85
1609,1289576949,1289576957,1289576964,8,7
1610,1289577027,1289577047,1289577053,20,6
1611,1289578487,1289578502,1289578502,15,0
1612,1289578522,1289578532,1289578532,10,0
1617,1289578734,1289578787,1289578792,53,5
1619,1289578943,1289578967,1289578972,24,5
1568,1289400211,1289400212,1289579129,1,178917
1620,1289582559,1289582567,1289582568,8,1
1621,1289582676,1289582687,1289582688,11,1
1622,1289583184,1289583197,1289583198,13,1
1624,1289583351,1289583362,1289583363,11,1
1625,1289583499,1289583512,1289583513,13,1
1626,1289583704,1289583707,1289583707,3,0
1627,1289583725,1289583737,1289583737,12,0
1629,1289583934,1289583947,1289583947,13,0
1632,1289584152,1289584172,1289584172,20,0
1633,1289584313,1289584322,1289584322,9,0
1634,1289584452,1289584458,1289584459,6,1
1637,1289585015,1289585027,1289585028,12,1
1481,1288956292,1288956302,1289600432,10,644130
1578,1289558879,1289559137,1289655764,258,96627
1640,1289646863,1289646872,1289659072,9,12200
1428,1288352725,1289655782,1289669157,1303057,13375
1579,1289561520,1289561522,1289675081,2,113559
1639,1289646859,1289646872,1289676143,13,29271
1638,1289646856,1289646857,1289686754,1,39897
1628,1289583851,1289583857,1289707044,6,123187
1413,1288250390,1289655782,1289710766,1405392,54984
1431,1288509034,1289669177,1289713745,1160143,44568
350,1282975241,1282975247,1289717002,6,6741755
1653,1289720072,1289720192,1289721132,120,940
1646,1289719638,1289719652,1289721449,14,1797
1647,1289719642,1289719652,1289721641,10,1989
1643,1289719627,1289719637,1289722038,10,2401
1642,1289719624,1289719637,1289722211,13,2574
1650,1289719655,1289721692,1289723127,2037,1435
1644,1289719631,1289719637,1289724038,6,4401
1652,1289719678,1289722247,1289724508,2569,2261
1645,1289719634,1289719637,1289725289,3,5652
1649,1289719652,1289721482,1289727031,1830,5549
1654,1289720242,1289723177,1289736401,2935,13224
1651,1289719660,1289722052,1289739139,2392,17087
1432,1288509038,1289710787,1289751626,1201749,40839
1436,1288598022,1289713787,1289757087,1115765,43300
1623,1289583270,1289757107,1289757107,173837,0
1657,1289811812,1289811827,1289811834,15,7
1662,1289811812,1289811827,1289811834,15,7
1665,1289811812,1289811827,1289811834,15,7
1663,1289811812,1289811827,1289811834,15,7
1661,1289811812,1289811827,1289811832,15,5
1667,1289811812,1289811827,1289811833,15,6
1664,1289811812,1289811827,1289811834,15,7
1668,1289811812,1289811827,1289811835,15,8
1666,1289811812,1289811827,1289811833,15,6
1658,1289811812,1289811827,1289811832,15,5
1659,1289811812,1289811827,1289811833,15,6
1660,1289811812,1289811827,1289811833,15,6
1669,1289811812,1289811872,1289811877,60,5
1670,1289811812,1289811887,1289811892,75,5
1671,1289811812,1289811887,1289811892,75,5
1672,1289811812,1289811887,1289811892,75,5
1675,1289811812,1289811887,1289811891,75,4
1673,1289811812,1289811887,1289811892,75,5
1674,1289811812,1289811887,1289811892,75,5
1676,1289811812,1289811902,1289811907,90,5
1677,1289811812,1289811902,1289811907,90,5
1678,1289811812,1289811902,1289811907,90,5
1679,1289811812,1289811917,1289811921,105,4
1680,1289811812,1289811917,1289811922,105,5
1681,1289811812,1289811917,1289811921,105,4
1682,1289811812,1289811917,1289811922,105,5
1683,1289811812,1289811917,1289811921,105,4
1684,1289811812,1289811917,1289811922,105,5
1686,1289811812,1289811932,1289811938,120,6
1685,1289811812,1289811932,1289811938,120,6
1687,1289811812,1289811932,1289811938,120,6
1688,1289811812,1289811932,1289811936,120,4
1689,1289811812,1289811932,1289811938,120,6
1690,1289811812,1289811947,1289811952,135,5
1691,1289811812,1289811947,1289811954,135,7
1692,1289811812,1289811947,1289811953,135,6
1693,1289811812,1289811962,1289811968,150,6
1694,1289811812,1289811962,1289811973,150,11
1695,1289811812,1289811962,1289811966,150,4
1696,1289811812,1289811962,1289811971,150,9
1698,1289811813,1289811977,1289811981,164,4
1697,1289811812,1289811977,1289811984,165,7
1699,1289811813,1289811977,1289811983,164,6
1700,1289811813,1289811977,1289811982,164,5
1702,1289811960,1289811992,1289811996,32,4
1703,1289811981,1289811992,1289811995,11,3
1704,1289811982,1289811992,1289811996,10,4
1705,1289811984,1289811992,1289811996,8,4
1706,1289811984,1289812037,1289812043,53,6
1707,1289812438,1289812442,1289812443,4,1
1709,1289813390,1289813402,1289813408,12,6
1711,1289813765,1289813777,1289813781,12,4
1710,1289813685,1289813687,1289813903,2,216
1712,1289813999,1289814002,1289814008,3,6
1714,1289814641,1289814647,1289814651,6,4
1716,1289816031,1289816042,1289816047,11,5
1715,1289816003,1289816012,1289816017,9,5
1719,1289816031,1289816042,1289816047,11,5
1717,1289816031,1289816042,1289816046,11,4
1718,1289816031,1289816042,1289816047,11,5
1724,1289816031,1289816042,1289816065,11,23
1722,1289816031,1289816042,1289816065,11,23
1725,1289816031,1289816042,1289816044,11,2
1708,1289812497,1289812502,1289816139,5,3637
1731,1289816031,1289816117,1289816139,86,22
1770,1289816192,1289816207,1289816212,15,5
1771,1289816192,1289816207,1289816214,15,7
1765,1289816192,1289816207,1289816212,15,5
1766,1289816192,1289816207,1289816212,15,5
1773,1289816192,1289816222,1289816227,30,5
1760,1289816192,1289816229,1289816236,37,7
1762,1289816192,1289816207,1289816211,15,4
1774,1289816192,1289816237,1289816242,45,5
1761,1289816192,1289816207,1289816212,15,5
1768,1289816192,1289816207,1289816212,15,5
1767,1289816192,1289816207,1289816212,15,5
1772,1289816192,1289816207,1289816212,15,5
1769,1289816192,1289816207,1289816212,15,5
1763,1289816192,1289816207,1289816212,15,5
1764,1289816192,1289816207,1289816211,15,4
1775,1289816192,1289816252,1289816257,60,5
1776,1289816192,1289816252,1289816257,60,5
1778,1289816192,1289816267,1289816272,75,5
1777,1289816192,1289816267,1289816267,75,0
1779,1289816192,1289816267,1289816272,75,5
1780,1289816192,1289816267,1289816272,75,5
1781,1289816192,1289816282,1289816285,90,3
1782,1289816192,1289816282,1289816287,90,5
1783,1289816192,1289816282,1289816286,90,4
1784,1289816192,1289816282,1289816287,90,5
1785,1289816192,1289816297,1289816301,105,4
1786,1289816192,1289816297,1289816302,105,5
1787,1289816192,1289816297,1289816302,105,5
1788,1289816192,1289816297,1289816301,105,4
1789,1289816192,1289816297,1289816303,105,6
1791,1289816192,1289816312,1289816318,120,6
1790,1289816192,1289816312,1289816312,120,0
1792,1289816192,1289816312,1289816317,120,5
1793,1289816192,1289816312,1289816319,120,7
1794,1289816192,1289816312,1289816318,120,6
1795,1289816192,1289816312,1289816318,120,6
1796,1289816192,1289816327,1289816338,135,11
1797,1289816192,1289816327,1289816331,135,4
1798,1289816192,1289816327,1289816336,135,9
1799,1289816192,1289816327,1289816334,135,7
1800,1289816192,1289816327,1289816331,135,4
1802,1289816192,1289816342,1289816347,150,5
1803,1289816229,1289816342,1289816347,113,5
1801,1289816192,1289816342,1289816342,150,0
1809,1289816417,1289816432,1289816437,15,5
1810,1289816417,1289816432,1289816437,15,5
1811,1289816417,1289816432,1289816437,15,5
1812,1289816417,1289816432,1289816436,15,4
1813,1289816417,1289816432,1289816437,15,5
1814,1289816417,1289816432,1289816437,15,5
1815,1289816417,1289816432,1289816438,15,6
1804,1289816417,1289816432,1289816437,15,5
1805,1289816417,1289816432,1289816437,15,5
1806,1289816417,1289816432,1289816437,15,5
1807,1289816417,1289816432,1289816437,15,5
1808,1289816417,1289816432,1289816436,15,4
1816,1289816417,1289816477,1289816482,60,5
1817,1289816418,1289816477,1289816482,59,5
1818,1289816418,1289816492,1289816497,74,5
1819,1289816418,1289816492,1289816497,74,5
1820,1289816418,1289816492,1289816497,74,5
1821,1289816418,1289816492,1289816497,74,5
1822,1289816418,1289816492,1289816497,74,5
1823,1289816418,1289816507,1289816512,89,5
1824,1289816418,1289816507,1289816512,89,5
1825,1289816418,1289816507,1289816512,89,5
1826,1289816418,1289816522,1289816525,104,3
1827,1289816418,1289816522,1289816527,104,5
1828,1289816418,1289816522,1289816526,104,4
1829,1289816418,1289816522,1289816527,104,5
1830,1289816418,1289816537,1289816541,119,4
1831,1289816418,1289816537,1289816542,119,5
1832,1289816418,1289816537,1289816542,119,5
1833,1289816418,1289816537,1289816542,119,5
1834,1289816418,1289816537,1289816543,119,6
1835,1289816418,1289816552,1289816555,134,3
1836,1289816418,1289816552,1289816558,134,6
1837,1289816418,1289816552,1289816557,134,5
1838,1289816418,1289816552,1289816558,134,6
1839,1289816418,1289816552,1289816558,134,6
1840,1289816418,1289816567,1289816573,149,6
1841,1289816418,1289816567,1289816577,149,10
1842,1289816418,1289816567,1289816571,149,4
1843,1289816418,1289816567,1289816574,149,7
1844,1289816418,1289816567,1289816574,149,7
1845,1289816418,1289816582,1289816585,164,3
1846,1289816418,1289816582,1289816588,164,6
1847,1289816418,1289816582,1289816588,164,6
1713,1289814369,1289814377,1289819572,8,5195
1848,1289820438,1289820452,1289820452,14,0
1849,1289820506,1289820512,1289820516,6,4
1850,1289820542,1289820557,1289820560,15,3
1851,1289820542,1289820557,1289820562,15,5
1852,1289820542,1289820557,1289820561,15,4
1853,1289820542,1289820557,1289820560,15,3
1854,1289820542,1289820557,1289820564,15,7
1855,1289820542,1289820557,1289820560,15,3
1856,1289821365,1289821367,1289821371,2,4
1860,1289821399,0,0,-1289821399,0
1863,1289821441,1289821442,1289821591,1,149
1437,1288598026,1289751663,1289821687,1153637,70024
1864,1289822413,1289822417,1289822421,4,4
1865,1289822501,1289822507,1289822510,6,3
1866,1289824552,1289824562,1289824566,10,4
1867,1289824555,1289824562,1289824566,7,4
1868,1289824674,1289824682,1289824686,8,4
1869,1289824754,1289824757,1289824761,3,4
1871,1289824852,1289824862,1289824865,10,3
1872,1289824893,1289824952,1289824963,59,11
1873,1289824992,1289824997,1289825003,5,6
1879,1289825052,1289825072,1289825075,20,3
1878,1289825052,1289825057,1289825061,5,4
1882,1289825052,1289825072,1289825077,20,5
1874,1289825052,1289825057,1289825062,5,5
1877,1289825052,1289825057,1289825062,5,5
1875,1289825052,1289825057,1289825062,5,5
1876,1289825052,1289825057,1289825062,5,5
1881,1289825052,1289825072,1289825077,20,5
1884,1289825052,1289825117,1289825122,65,5
1883,1289825052,1289825117,1289825122,65,5
1885,1289825052,1289825117,1289825124,65,7
1880,1289825052,1289825072,1289825077,20,5
1886,1289825052,1289825117,1289825122,65,5
1887,1289825052,1289825117,1289825122,65,5
1888,1289825052,1289825132,1289825136,80,4
1889,1289825052,1289825132,1289825137,80,5
1890,1289825052,1289825147,1289825152,95,5
1892,1289825052,1289825147,1289825152,95,5
1891,1289825052,1289825147,1289825152,95,5
1893,1289825052,1289825162,1289825167,110,5
1894,1289825052,1289825162,1289825167,110,5
1895,1289825052,1289825162,1289825166,110,4
1896,1289825052,1289825162,1289825166,110,4
1897,1289825052,1289825177,1289825182,125,5
1898,1289825052,1289825177,1289825180,125,3
1899,1289825052,1289825192,1289825196,140,4
1901,1289825052,1289825192,1289825197,140,5
1900,1289825052,1289825192,1289825196,140,4
1902,1289825052,1289825192,1289825196,140,4
1903,1289825053,1289825192,1289825197,139,5
1904,1289825053,1289825207,1289825212,154,5
1905,1289825053,1289825207,1289825211,154,4
1906,1289825053,1289825207,1289825211,154,4
1907,1289825053,1289825222,1289825227,169,5
1908,1289825053,1289825222,1289825229,169,7
1910,1289825053,1289825237,1289825243,184,6
1909,1289825053,1289825237,1289825243,184,6
1912,1289825053,1289825237,1289825241,184,4
1911,1289825053,1289825237,1289825248,184,11
1913,1289825053,1289825237,1289825246,184,9
1914,1289825053,1289825237,1289825244,184,7
1915,1289825053,1289825252,1289825256,199,4
1916,1289825053,1289825252,1289825257,199,5
1917,1289825053,1289825267,1289825272,214,5
1918,1289825288,1289825297,1289825312,9,15
1919,1289825325,1289825357,1289826068,32,711
1858,1289821381,1289821382,1289827329,1,5947
1921,1289827325,1289827337,1289827340,12,3
1920,1289827312,1289827322,1289827326,10,4
1922,1289827392,1289827397,1289827402,5,5
1923,1289827395,1289827397,1289827401,2,4
1924,1289827398,1289827412,1289827417,14,5
1925,1289827424,1289827427,1289827431,3,4
1926,1289827426,1289827427,1289827431,1,4
1927,1289827429,1289827442,1289827446,13,4
1928,1289827480,1289827487,1289827492,7,5
1929,1289827584,1289827592,1289827596,8,4
1930,1289827643,1289827652,1289827668,9,16
1931,1289827705,1289827712,1289827715,7,3
1932,1289827755,1289827757,1289827760,2,3
1933,1289827995,1289827997,1289827999,2,2
1934,1289828110,1289828117,1289828124,7,7
1861,1289821425,1289821427,1289828296,2,6869
1967,1289828584,1289828597,1289828606,13,9
1968,1289828584,1289828597,1289828602,13,5
1973,1289828584,1289828597,1289828605,13,8
1974,1289828584,1289828597,1289828604,13,7
1951,1289828584,1289828597,1289828602,13,5
1952,1289828584,1289828597,1289828602,13,5
1953,1289828584,1289828597,1289828602,13,5
1954,1289828584,1289828597,1289828602,13,5
1977,1289828584,1289828597,1289828603,13,6
1978,1289828584,1289828597,1289828603,13,6
1975,1289828584,1289828597,1289828613,13,16
1976,1289828584,1289828597,1289828611,13,14
1955,1289828584,1289828597,1289828602,13,5
1956,1289828584,1289828597,1289828603,13,6
1957,1289828584,1289828597,1289828601,13,4
1958,1289828584,1289828597,1289828602,13,5
1963,1289828584,1289828597,1289828605,13,8
1964,1289828584,1289828597,1289828606,13,9
1965,1289828584,1289828597,1289828607,13,10
1966,1289828584,1289828597,1289828605,13,8
1969,1289828584,1289828597,1289828605,13,8
1970,1289828584,1289828597,1289828606,13,9
1971,1289828584,1289828597,1289828604,13,7
1972,1289828584,1289828597,1289828616,13,19
1935,1289828583,1289828597,1289828602,14,5
1936,1289828583,1289828597,1289828602,14,5
1937,1289828583,1289828597,1289828602,14,5
1938,1289828583,1289828597,1289828602,14,5
1959,1289828584,1289828597,1289828603,13,6
1960,1289828584,1289828597,1289828603,13,6
1961,1289828584,1289828597,1289828602,13,5
1962,1289828584,1289828597,1289828603,13,6
1939,1289828583,1289828597,1289828602,14,5
1940,1289828583,1289828597,1289828603,14,6
1941,1289828583,1289828597,1289828602,14,5
1942,1289828583,1289828597,1289828602,14,5
1943,1289828583,1289828597,1289828601,14,4
1944,1289828583,1289828597,1289828601,14,4
1945,1289828584,1289828597,1289828601,13,4
1946,1289828584,1289828597,1289828606,13,9
1947,1289828584,1289828597,1289828602,13,5
1948,1289828584,1289828597,1289828601,13,4
1949,1289828584,1289828597,1289828602,13,5
1950,1289828584,1289828597,1289828601,13,4
1857,1289821373,1289821382,1289829467,9,8085
1862,1289821431,1289821442,1289830919,11,9477
1859,1289821390,1289821397,1289832648,7,11251
1981,1289834205,1289834207,1289834243,2,36
1982,1289834332,1289834342,1289834354,10,12
1983,1289834483,1289834492,1289834586,9,94
1984,1289840093,1289840102,1289840106,9,4
1985,1289840094,1289840102,1289840106,8,4
1986,1289840094,1289840102,1289840106,8,4
1987,1289840094,1289840102,1289840106,8,4
1988,1289840094,1289840102,1289840107,8,5
1989,1289840094,1289840102,1289840106,8,4
1990,1289840094,1289840102,1289840107,8,5
1991,1289840094,1289840102,1289840107,8,5
1996,1289840094,1289840102,1289840106,8,4
1997,1289840094,1289840102,1289840106,8,4
1998,1289840094,1289840102,1289840106,8,4
1999,1289840094,1289840102,1289840106,8,4
2008,1289840094,1289840102,1289840106,8,4
2009,1289840094,1289840102,1289840105,8,3
2010,1289840094,1289840102,1289840106,8,4
2011,1289840094,1289840102,1289840106,8,4
2000,1289840094,1289840102,1289840107,8,5
2001,1289840094,1289840102,1289840107,8,5
2002,1289840094,1289840102,1289840107,8,5
2003,1289840094,1289840102,1289840107,8,5
1992,1289840094,1289840102,1289840107,8,5
1993,1289840094,1289840102,1289840107,8,5
1994,1289840094,1289840102,1289840107,8,5
1995,1289840094,1289840102,1289840112,8,10
2004,1289840094,1289840102,1289840107,8,5
2005,1289840094,1289840102,1289840108,8,6
2006,1289840094,1289840102,1289840107,8,5
2007,1289840094,1289840102,1289840107,8,5
2024,1289840094,1289840102,1289840116,8,14
2025,1289840094,1289840102,1289840106,8,4
2026,1289840094,1289840102,1289840107,8,5
2027,1289840094,1289840102,1289840108,8,6
2016,1289840094,1289840102,1289840107,8,5
2017,1289840094,1289840102,1289840108,8,6
2018,1289840094,1289840102,1289840110,8,8
2019,1289840094,1289840102,1289840110,8,8
2020,1289840094,1289840102,1289840107,8,5
2021,1289840094,1289840102,1289840117,8,15
2022,1289840094,1289840102,1289840110,8,8
2023,1289840094,1289840102,1289840109,8,7
2012,1289840094,1289840102,1289840108,8,6
2013,1289840094,1289840102,1289840110,8,8
2014,1289840094,1289840102,1289840110,8,8
2015,1289840094,1289840102,1289840106,8,4
2028,1289840224,1289840237,1289840348,13,111
2031,1289840675,1289840687,1289840691,12,4
2032,1289840679,1289840687,1289840690,8,3
2033,1289840681,1289840687,1289840690,6,3
2034,1289840685,1289840687,1289840690,2,3
2035,1289840687,1289840702,1289840705,15,3
2036,1289840779,1289840792,1289840805,13,13
2037,1289841463,1289841467,1289841559,4,92
2038,1289841536,1289841542,1289841635,6,93
2039,1289841540,1289841542,1289841635,2,93
2030,1289840509,1289840522,1289842724,13,2202
2029,1289840365,1289840372,1289845553,7,5181
1980,1289834118,1289834132,1289860848,14,26716
2040,1289894329,1289894342,1289894626,13,284
2041,1289894333,1289894342,1289894626,9,284
2042,1289894400,1289894402,1289894654,2,252
2045,1289901334,1289901347,1289901510,13,163
2046,1289905408,1289905412,1289905412,4,0
2047,1289905433,1289905442,1289905442,9,0
1641,1289716627,1289821712,1289904488,105085,82776
1979,1289832342,1289906747,1289906748,74405,1
2048,1289908966,1289908967,1289909062,1,95
2049,1289919391,1289919392,1289919425,1,33
2053,1289919555,1289919557,1289919557,2,0
2052,1289919546,1289919557,1289919557,11,0
2098,1289921757,1289921762,1289921766,5,4
2099,1289921759,1289921762,1289921766,3,4
2100,1289921761,1289921762,1289921765,1,3
2101,1289922676,1289922677,1289922681,1,4
2102,1289922680,1289922692,1289922695,12,3
2103,1289922681,1289922692,1289922695,11,3
2104,1289922733,1289922737,1289922741,4,4
2105,1289927506,1289927507,1289927511,1,4
2106,1289927595,1289927597,1289927600,2,3
2107,1289927597,1289927612,1289927616,15,4
2108,1289927671,1289927672,1289927678,1,6
2109,1289927673,1289927687,1289927690,14,3
1635,1289584617,1289584622,1289981069,5,396447
2112,1289992020,1289992023,1289994058,3,2035
2115,1289994613,1289994618,1289994632,5,14
2111,1289990652,1289990658,1289995911,6,5253
2116,1290004997,1290004998,1290005006,1,8
2119,1290005007,1290005013,1290005025,6,12
2132,1290009750,1290009753,1290009847,3,94
2133,1290010623,1290010638,1290010660,15,22
2043,1289894723,1289894732,1290011335,9,116603
2134,1290011324,1290011328,1290011407,4,79
2051,1289919438,1289919482,1290009617,44,90135
2135,1290012121,1290012123,1290012134,2,11
2136,1290012166,1290012168,1290012178,2,10
2137,1290013389,1290013398,1290013473,9,75
2138,1290013726,1290013728,1290013772,2,44
2139,1290013952,1290013953,1290013964,1,11
2131,1290008510,1290008523,1290016561,13,8038
2140,1290017301,1290017313,1290017402,12,89
2141,1290017381,1290017388,1290017400,7,12
2142,1290022625,1290022638,1290022650,13,12
2143,1290023111,1290023118,1290023370,7,252
2144,1290023753,1290023763,1290023786,10,23
2145,1290030627,1290030633,1290030876,6,243
2044,1289894777,1289894792,1290037547,15,142755
2122,1290006147,1290037593,1290037628,31446,35
2123,1290006191,1290037668,1290037676,31477,8
2124,1290006195,1290037713,1290037747,31518,34
2118,1290005003,1290005013,1290041953,10,36940
2121,1290005065,1290005073,1290047744,8,42671
2146,1290077335,1290077343,1290077343,8,0
2151,1290083242,1290083253,1290083392,11,139
2150,1290083231,1290083238,1290083381,7,143
2153,1290083263,1290083268,1290083466,5,198
2156,1290083307,1290083313,1290083461,6,148
2157,1290083314,1290083328,1290083496,14,168
2154,1290083273,1290083283,1290083500,10,217
2155,1290083291,1290083298,1290083557,7,259
2152,1290083254,1290083268,1290083561,14,293
2161,1290084091,1290084093,1290084106,2,13
2162,1290084116,1290084123,1290084287,7,164
2166,1290090258,1290090265,1290090265,7,0
2167,1290090552,1290090565,1290090565,13,0
2168,1290090809,1290090820,1290090820,11,0
2169,1290090889,1290090895,1290090896,6,1
2050,1289919420,1290012003,1290091061,92583,79058
2163,1290084139,1290084153,1290091555,14,7402
2170,1290091004,1290091015,1290091713,11,698
2160,1290084086,1290084093,1290092133,7,8040
2171,1290091068,1290091075,1290092346,7,1271
2172,1290091078,1290091773,1290092342,695,569
2174,1290091170,1290091180,1290092468,10,1288
2173,1290091162,1290092486,1290092531,1324,45
2158,1290084066,1290084078,1290093497,12,9419
2176,1290094956,1290094960,1290094963,4,3
2175,1290094922,1290094930,1290094931,8,1
2164,1290084146,1290084153,1290095410,7,11257
2177,1290095152,1290095156,1290095713,4,557
2178,1290096469,1290096475,1290096482,6,7
2179,1290096843,1290096850,1290097034,7,184
2182,1290096988,1290097001,1290097034,13,33
2180,1290096918,1290096925,1290097034,7,109
2181,1290096983,1290096985,1290097034,2,49
2183,1290097125,1290097137,1290097191,12,54
2192,1290098438,1290098441,1290098488,3,47
2188,1290097995,1290098005,1290098730,10,725
2193,1290098442,1290098786,1290098869,344,83
2191,1290098435,1290098441,1290099081,6,640
2190,1290098429,1290098545,1290099345,116,800
2195,1290099920,1290099926,1290099985,6,59
2196,1290100071,1290100075,1290100075,4,0
2198,1290100146,1290100150,1290100155,4,5
2199,1290100191,1290100225,1290100231,34,6
2200,1290100440,1290100450,1290100456,10,6
2194,1290099918,1290099926,1290100526,8,600
2201,1290100440,1290100525,1290100560,85,35
2203,1290100440,1290100616,1290100628,176,12
2202,1290100440,1290100585,1290100590,145,5
2204,1290100441,1290100690,1290100699,249,9
2205,1290100441,1290100706,1290100716,265,10
2206,1290100441,1290100765,1290100779,324,14
2207,1290100441,1290100781,1290100796,340,15
2208,1290100441,1290100825,1290100856,384,31
2209,1290100441,1290100855,1290100910,414,55
2211,1290100441,1290100990,1290100999,549,9
2212,1290100441,1290101050,1290101060,609,10
2197,1290100075,1290100091,1290101113,16,1022
2210,1290100441,1290100901,1290101123,460,222
2213,1290100441,1290101125,1290101134,684,9
2215,1290100441,1290101185,1290101208,744,23
2216,1290100441,1290101185,1290101206,744,21
2214,1290100441,1290101185,1290101194,744,9
2217,1290100441,1290101260,1290101276,819,16
2218,1290100441,1290101260,1290101267,819,7
2219,1290100441,1290101290,1290101298,849,8
2220,1290100441,1290101320,1290101329,879,9
2221,1290100441,1290101335,1290101346,894,11
2222,1290100441,1290101350,1290101369,909,19
2223,1290100441,1290101380,1290101400,939,20
2224,1290100441,1290101425,1290101437,984,12
2227,1290100441,1290101485,1290101506,1044,21
2225,1290100441,1290101455,1290101546,1014,91
2226,1290100441,1290101470,1290101600,1029,130
2228,1290100441,1290101575,1290101591,1134,16
2230,1290100441,1290101650,1290101660,1209,10
2229,1290100441,1290101605,1290101614,1164,9
2231,1290100441,1290101666,1290101676,1225,10
2234,1290100441,1290101710,1290101724,1269,14
2232,1290100441,1290101695,1290101705,1254,10
2233,1290100441,1290101710,1290101717,1269,7
2235,1290100441,1290101770,1290101791,1329,21
2237,1290100441,1290101786,1290101800,1345,14
2236,1290100441,1290101786,1290101801,1345,15
2238,1290100441,1290101845,1290101856,1404,11
2239,1290100442,1290101860,1290101868,1418,8
2240,1290100442,1290101875,1290101884,1433,9
2241,1290100442,1290101935,1290101953,1493,18
2243,1290100442,1290101980,1290101988,1538,8
2242,1290100442,1290101966,1290102043,1524,77
2245,1290100442,1290102056,1290102104,1614,48
2246,1290100442,1290102130,1290102156,1688,26
2244,1290100442,1290102025,1290102144,1583,119
2247,1290100442,1290102175,1290102184,1733,9
2248,1290100442,1290102175,1290102199,1733,24
2250,1290100442,1290102251,1290102266,1809,15
2249,1290100442,1290102220,1290102264,1778,44
2251,1290100442,1290102265,1290102313,1823,48
2253,1290100442,1290102325,1290102348,1883,23
2252,1290100442,1290102310,1290102345,1868,35
2255,1290100442,1290102385,1290102403,1943,18
2254,1290100442,1290102370,1290102384,1928,14
2257,1290100442,1290102446,1290102464,2004,18
2258,1290100442,1290102460,1290102471,2018,11
2256,1290100442,1290102415,1290102551,1973,136
2260,1290100442,1290102550,1290102562,2108,12
2259,1290100442,1290102535,1290102568,2093,33
2262,1290100442,1290102625,1290102633,2183,8
2261,1290100442,1290102610,1290102619,2168,9
2264,1290100442,1290102686,1290102704,2244,18
2263,1290100442,1290102625,1290102741,2183,116
2265,1290100442,1290102700,1290102733,2258,33
2266,1290100442,1290102775,1290102781,2333,6
2268,1290100442,1290102820,1290102840,2378,20
2267,1290100442,1290102805,1290102836,2363,31
2269,1290100442,1290102866,1290102873,2424,7
2271,1290100442,1290102910,1290102919,2468,9
2272,1290100442,1290102925,1290102934,2483,9
2270,1290100442,1290102910,1290102937,2468,27
2273,1290100442,1290102986,1290102989,2544,3
2275,1290100443,1290103015,1290103038,2572,23
2274,1290100442,1290103015,1290103048,2573,33
2276,1290100443,1290103030,1290103052,2587,22
2277,1290100443,1290103090,1290103107,2647,17
2279,1290100443,1290103105,1290103155,2662,50
2280,1290100443,1290103135,1290103153,2692,18
2281,1290100443,1290103195,1290103209,2752,14
2278,1290100443,1290103105,1290103277,2662,172
2282,1290100443,1290103225,1290103287,2782,62
2283,1290100443,1290103285,1290103307,2842,22
2284,1290100443,1290103331,1290103354,2888,23
2286,1290100443,1290103375,1290103385,2932,10
2285,1290100443,1290103345,1290103372,2902,27
2287,1290100443,1290103390,1290103416,2947,26
2288,1290100443,1290103450,1290103464,3007,14
2289,1290100443,1290103465,1290103476,3022,11
2290,1290100443,1290103465,1290103485,3022,20
2291,1290100443,1290103525,1290103569,3082,44
2292,1290100443,1290103540,1290103548,3097,8
2293,1290100443,1290103570,1290103583,3127,13
2296,1290100443,1290103660,1290103676,3217,16
2294,1290100443,1290103630,1290103648,3187,18
2295,1290100443,1290103645,1290103684,3202,39
2159,1290084077,1290084078,1290115546,1,31468
2147,1290077483,1290077493,1290122953,10,45460
1412,1288250384,1289559173,1290136583,1308789,577410
2120,1290005048,1290011343,1290149987,6295,138644
2297,1290157352,1290157361,1290157421,9,60
2299,1290157735,1290157751,1290158226,16,475
2300,1290158367,1290158380,1290158380,13,0
2302,1290158403,1290158410,1290158412,7,2
2314,1290158526,1290158530,1290158530,4,0
2110,1289986874,1290012003,1290158793,25129,146790
2320,1290168321,1290168325,1290168328,4,3
2321,1290168416,1290168430,1290168431,14,1
2322,1290171107,1290171115,1290171117,8,2
2305,1290158411,1290158425,1290179532,14,21107
2307,1290158419,1290158425,1290182523,6,24098
2306,1290158417,1290158425,1290182580,8,24155
2304,1290158408,1290158410,1290183988,2,25578
2117,1290005000,1290005088,1290186015,88,180927
2301,1290158399,1290158500,1290205011,101,46511
2308,1290158423,1290158425,1290215094,2,56669
1259,1286953476,1287359103,1290220890,405627,2861787
2148,1290077687,1290220916,1290220980,143229,64
2313,1290158512,1290220990,1290221054,62478,64
2309,1290158425,1290167005,1290223390,8580,56385
2303,1290158404,1290158410,1290223697,6,65287
2312,1290158479,1290182560,1290229125,24081,46565
2311,1290158473,1290179547,1290229910,21074,50363
1395,1288187025,1288924487,1290236835,737462,1312348
2317,1290159902,1290236875,1290236936,76973,61
2330,1290249367,1290249370,1290249793,3,423
2323,1290249345,1290249355,1290250544,10,1189
2347,1290250395,1290250405,1290251229,10,824
2341,1290249415,1290249835,1290251356,420,1521
2345,1290250382,1290250585,1290252763,203,2178
2331,1290249373,1290249385,1290253093,12,3708
2333,1290249379,1290253120,1290253120,3741,0
2336,1290249388,1290249400,1290254850,12,5450
2351,1290250464,1290252775,1290255572,2311,2797
2346,1290250391,1290251395,1290255549,1004,4154
2315,1290159702,1290221080,1290260191,61378,39111
2338,1290249396,1290249400,1290269526,4,20126
2324,1290249349,1290249355,1290269590,6,20235
2332,1290249376,1290249385,1290270278,9,20893
2326,1290249355,1290249370,1290275150,15,25780
2335,1290249385,1290255580,1290275202,6195,19622
1425,1288351666,1288351667,1290275513,1,1923846
2339,1290249400,1290270310,1290281017,20910,10707
2327,1290249358,1290249370,1290282145,12,32775
2337,1290249391,1290269635,1290285070,20244,15435
2329,1290249364,1290249370,1290285161,6,35791
2340,1290249403,1290275170,1290286495,25767,11325
2298,1290157509,1290157510,1290288159,1,130649
2344,1290249648,1290275545,1290288899,25897,13354
2126,1290006887,1290091090,1290290199,84203,199109
2325,1290249352,1290249355,1290299054,3,49699
2349,1290250412,1290285115,1290327139,34703,42024
2348,1290250399,1290282160,1290331873,31761,49713
2328,1290249361,1290260245,1290339723,10884,79478
2343,1290249570,1290275545,1290351639,25975,76094
2350,1290250457,1290288940,1290357905,38483,68965
2355,1290361089,1290361090,1290361095,1,5
2356,1290361222,1290361225,1290361393,3,168
2334,1290249381,1290253165,1290361759,3784,108594
2357,1290362074,1290362080,1290362097,6,17
2358,1290362129,1290362140,1290362157,11,17
2359,1290362861,1290362875,1290362899,14,24
2360,1290363057,1290363070,1290363255,13,185
2361,1290363061,1290363070,1290363252,9,182
2362,1290363258,1290363265,1290363576,7,311
2354,1290349465,1290349480,1290370876,15,21396
2318,1290160061,1290236875,1290395079,76814,158204
2125,1290006883,1290037788,1290403595,30905,365807
2363,1290413715,1290413725,1290413786,10,61
2316,1290159880,1290182605,1290421479,22725,238874
2366,1290415007,1290415015,1290439327,8,24312
2353,1290332277,1290332290,1290447207,13,114917
2367,1290415118,1290415120,1290451166,2,36046
2128,1290006911,1290150040,1290468401,143129,318361
2364,1290413855,1290413860,1290480265,5,66405
2365,1290414693,1290414700,1290485336,7,70636
1424,1288351661,1288351667,1290510758,6,2159091
2114,1289992794,1289992803,1290533764,9,540961
2369,1290509729,1290509740,1290562413,11,52673
2342,1290249479,1290275230,1290566336,25751,291106
1536,1289211073,1289211077,1290570687,4,1359610
2130,1290006919,1290186055,1290578026,179136,391971
2376,1290591325,1290591340,1290591340,15,0
2377,1290594151,1290594160,1290594306,9,146
2378,1290594238,1290594250,1290594311,12,61
2379,1290594899,1290594910,1290595014,11,104
2380,1290595111,1290595120,1290595201,9,81
2381,1290595145,1290595150,1290595235,5,85
2382,1290595252,1290595255,1290595485,3,230
2383,1290596126,1290596140,1290596384,14,244
2384,1290596211,1290596215,1290596412,4,197
2385,1290596461,1290596470,1290596492,9,22
2387,1290596584,1290596590,1290596688,6,98
2386,1290596515,1290596530,1290596767,15,237
2388,1290596700,1290596710,1290596765,10,55
2389,1290596767,1290596770,1290596904,3,134
2390,1290597600,1290597612,1290597754,12,142
2370,1290510076,1290510085,1290612033,9,101948
2372,1290591144,1290612055,1290621588,20911,9533
2373,1290591147,1290621610,1290631725,30463,10115
2374,1290591150,1290631765,1290639470,40615,7705
2352,1290250477,1290290215,1290644439,39738,354224
2375,1290591153,1290639490,1290649808,48337,10318
2392,1290695058,1290695065,1290695148,7,83
2393,1290695646,1290695650,1290695697,4,47
2394,1290699042,1290699055,1290699228,13,173
2395,1290699575,1290699580,1290699589,5,9
2397,1290701377,1290701380,1290701432,3,52
2396,1290699972,1290699985,1290701751,13,1766
2403,1290756457,1290756460,1290756471,3,11
2404,1290756500,1290756505,1290756542,5,37
2409,1290757151,1290757165,1290757165,14,0
2414,1290759742,1290759745,1290762122,3,2377
2415,1290759746,1290759760,1290762155,14,2395
2416,1290759749,1290759760,1290763133,11,3373
2400,1290755541,1290755545,1290772581,4,17036
2430,1290773870,1290773875,1290776559,5,2684
2407,1290757019,1290757030,1290779314,11,22284
2432,1290779688,1290779695,1290779725,7,30
2433,1290779926,1290779935,1290779968,9,33
2434,1290780018,1290780025,1290780047,7,22
2435,1290780177,1290780190,1290780199,13,9
2436,1290781856,1290781870,1290781902,14,32
1656,1289751698,1289751707,1290796702,9,1044995
2406,1290756782,1290756790,1290803207,8,46417
2431,1290779017,1290779020,1290805028,3,26008
2398,1290701438,1290701440,1290822233,2,120793
2129,1290006916,1290158800,1290871162,151884,712362
2408,1290757065,1290757075,1290874359,10,117284
2413,1290759731,1290779335,1290890926,19604,111591
2440,1290873087,1290873100,1290900672,13,27572
2368,1290415311,1290415315,1290905213,4,489898
2441,1290873169,1290873175,1290909374,6,36199
2442,1290929224,1290929230,1290929293,6,63
2443,1290929636,1290929650,1290929691,14,41
2444,1290929731,1290929740,1290929814,9,74
2418,1290768839,1290803245,1290935482,34406,132237
2417,1290768835,1290796750,1290935480,27915,138730
2420,1290768846,1290890980,1290935503,122134,44523
1655,1289734011,1289734023,1290940154,12,1206131
2448,1290935718,1290936025,1290979543,307,43518
2411,1290759434,1290759445,1290992360,11,232915
2412,1290759439,1290759445,1291003588,6,244143
2449,1290935721,1290936025,1291018084,304,82059
2460,1291024924,1291024930,1291024934,6,4
2452,1290935730,1290992680,1291034940,56950,42260
2410,1290759422,1290759430,1291039293,8,279863
2447,1290935716,1290935995,1291041408,279,105413
2463,1291043972,1291043980,1291044045,8,65
2464,1291046738,1291046740,1291046775,2,35
2465,1291046754,1291046755,1291046823,1,68
2462,1291040589,1291040590,1291071106,1,30516
2451,1290935727,1290979585,1291079499,43858,99914
2453,1290935735,1291003990,1291085404,68255,81414
2450,1290935724,1290940180,1291092505,4456,152325
1407,1288187860,1288502387,1291101587,314527,2599200
2461,1291029342,1291041445,1291119063,12103,77618
2445,1290935680,1290935695,1291166004,15,230309
2113,1289992095,1289992098,1291187553,3,1195455
2467,1291193526,1291193530,1291193531,4,1
2468,1291193637,1291193650,1291193651,13,1
2471,1291194793,1291194805,1291194806,12,1
2456,1290935744,1291039660,1291198670,103916,159010
2486,1291222880,1291222880,1291223692,0,812
2473,1291203203,1291203205,1291233082,2,29877
2454,1290935738,1291018120,1291234018,82382,215898
2477,1291211738,1291211740,1291235596,2,23856
2391,1290679215,1290679225,1291236301,10,557076
2476,1291211736,1291211740,1291236772,4,25032
2485,1291213444,1291236350,1291248761,22906,12411
2482,1291213430,1291233095,1291263968,19665,30873
2484,1291213442,1291235615,1291269189,22173,33574
2479,1291211751,1291211755,1291273029,4,61274
2474,1291211730,1291211740,1291282348,10,70608
2478,1291211748,1291211755,1291285414,7,73659
2475,1291211733,1291211740,1291287085,7,75345
2483,1291213439,1291234040,1291294101,20601,60061
2480,1291211795,1291211800,1291304290,5,92490
2401,1290755802,1290755815,1291322562,13,566747
2439,1290872638,1290872650,1291328789,12,456139
2488,1291297322,1291297325,1291348851,3,51526
2489,1291371551,1291371560,1291371565,9,5
2481,1291213427,1291213435,1291372378,8,158943
2493,1291372407,1291372415,1291372415,8,0
2491,1291372400,1291372415,1291372415,15,0
2492,1291372403,1291372415,1291372415,12,0
2494,1291372719,1291372730,1291372734,11,4
2495,1291372719,1291372730,1291372733,11,3
2496,1291372719,1291372730,1291372734,11,4
2497,1291372719,1291372730,1291372734,11,4
2518,1291372719,1291372730,1291372736,11,6
2519,1291372719,1291372730,1291372736,11,6
2520,1291372719,1291372730,1291372736,11,6
2521,1291372719,1291372730,1291372736,11,6
2522,1291372719,1291372730,1291372740,11,10
2523,1291372719,1291372730,1291372740,11,10
2524,1291372719,1291372730,1291372738,11,8
2525,1291372719,1291372730,1291372736,11,6
2526,1291372719,1291372730,1291372735,11,5
2527,1291372719,1291372730,1291372738,11,8
2528,1291372719,1291372730,1291372738,11,8
2529,1291372719,1291372730,1291372735,11,5
2510,1291372719,1291372730,1291372735,11,5
2511,1291372719,1291372730,1291372735,11,5
2512,1291372719,1291372730,1291372735,11,5
2513,1291372719,1291372730,1291372735,11,5
2502,1291372719,1291372730,1291372734,11,4
2503,1291372719,1291372730,1291372734,11,4
2504,1291372719,1291372730,1291372739,11,9
2505,1291372719,1291372730,1291372734,11,4
2506,1291372719,1291372730,1291372735,11,5
2507,1291372719,1291372730,1291372735,11,5
2508,1291372719,1291372730,1291372735,11,5
2509,1291372719,1291372730,1291372735,11,5
2534,1291372719,1291372730,1291372734,11,4
2535,1291372719,1291372730,1291372735,11,5
2536,1291372719,1291372730,1291372735,11,5
2498,1291372719,1291372730,1291372734,11,4
2499,1291372719,1291372730,1291372734,11,4
2500,1291372719,1291372730,1291372734,11,4
2501,1291372719,1291372730,1291372734,11,4
2514,1291372719,1291372730,1291372736,11,6
2515,1291372719,1291372730,1291372735,11,5
2516,1291372719,1291372730,1291372736,11,6
2517,1291372719,1291372730,1291372736,11,6
2530,1291372719,1291372730,1291372746,11,16
2531,1291372719,1291372730,1291372737,11,7
2532,1291372719,1291372730,1291372734,11,4
2533,1291372719,1291372730,1291372742,11,12
2371,1290510331,1290510340,1291378395,9,868055
2546,1291380669,1291380680,1291380686,11,6
2547,1291380669,1291380680,1291380686,11,6
2540,1291380669,1291380680,1291380685,11,5
2541,1291380669,1291380680,1291380686,11,6
2542,1291380669,1291380680,1291380685,11,5
2543,1291380669,1291380680,1291380685,11,5
2548,1291380669,1291380680,1291380686,11,6
2544,1291380669,1291380680,1291380685,11,5
2545,1291380669,1291380680,1291380686,11,6
2549,1291380669,1291380725,1291380730,56,5
2550,1291380669,1291380740,1291380745,71,5
2551,1291380669,1291380755,1291380761,86,6
2552,1291380669,1291380755,1291380760,86,5
2553,1291380669,1291380755,1291380760,86,5
2554,1291380669,1291380755,1291380760,86,5
2555,1291380669,1291380770,1291380775,101,5
2556,1291380669,1291380770,1291380775,101,5
2557,1291380669,1291380770,1291380775,101,5
2558,1291380669,1291380770,1291380775,101,5
2559,1291380670,1291380770,1291380775,100,5
2560,1291380670,1291380800,1291380805,130,5
2561,1291380670,1291380800,1291380805,130,5
2562,1291380670,1291380800,1291380804,130,4
2563,1291380670,1291380800,1291380805,130,5
2564,1291380670,1291380800,1291380805,130,5
2565,1291380670,1291380815,1291380820,145,5
2566,1291380670,1291380815,1291380820,145,5
2567,1291380670,1291380815,1291380820,145,5
2568,1291380670,1291380815,1291380820,145,5
2569,1291380670,1291380830,1291380835,160,5
2570,1291380670,1291380845,1291380851,175,6
2571,1291380670,1291380845,1291380870,175,25
2572,1291380670,1291380845,1291380851,175,6
2573,1291380670,1291380845,1291380850,175,5
2574,1291380670,1291380845,1291380852,175,7
2575,1291380670,1291380845,1291380851,175,6
2576,1291380670,1291380845,1291380850,175,5
2577,1291380670,1291380860,1291380871,190,11
2578,1291380670,1291380875,1291380900,205,25
2579,1291380670,1291380875,1291380880,205,5
2580,1291380670,1291380875,1291380882,205,7
2581,1291380670,1291380875,1291380879,205,4
2582,1291380670,1291380890,1291380896,220,6
2583,1291380670,1291380890,1291380895,220,5
2584,1291380675,1291380890,1291380895,215,5
2585,1291380675,1291380890,1291380895,215,5
2586,1291380675,1291380890,1291380894,215,4
2587,1291380675,1291380920,1291380925,245,5
2588,1291380675,1291380920,1291380945,245,25
2589,1291380676,1291380920,1291380945,244,25
2590,1291380676,1291380920,1291380925,244,5
2591,1291380676,1291380920,1291380924,244,4
2592,1291380676,1291380935,1291380940,259,5
2593,1291380676,1291380935,1291380940,259,5
2594,1291380676,1291380935,1291380940,259,5
2595,1291380676,1291380935,1291380942,259,7
2596,1291380676,1291380950,1291380955,274,5
2597,1291380676,1291380965,1291380970,289,5
2598,1291380676,1291380965,1291380970,289,5
2599,1291380676,1291380965,1291380970,289,5
2600,1291380676,1291380965,1291380970,289,5
2601,1291380676,1291380965,1291380970,289,5
2602,1291380676,1291380965,1291380970,289,5
2603,1291380676,1291380965,1291380970,289,5
2604,1291380676,1291380980,1291380985,304,5
2605,1291380676,1291380995,1291381000,319,5
2606,1291380676,1291380995,1291381000,319,5
2607,1291380676,1291380995,1291381000,319,5
2608,1291380676,1291380995,1291381020,319,25
2609,1291380676,1291381010,1291381014,334,4
2610,1291380676,1291381010,1291381015,334,5
2611,1291380676,1291381010,1291381015,334,5
2612,1291380676,1291381010,1291381015,334,5
2613,1291380676,1291381010,1291381016,334,6
2614,1291380676,1291381040,1291381046,364,6
2615,1291380676,1291381040,1291381044,364,4
2616,1291380676,1291381040,1291381047,364,7
2617,1291380676,1291381040,1291381044,364,4
2618,1291380676,1291381040,1291381046,364,6
2619,1291380676,1291381055,1291381061,379,6
2620,1291380676,1291381055,1291381060,379,5
2621,1291380676,1291381055,1291381065,379,10
2622,1291380676,1291381055,1291381059,379,4
2623,1291380676,1291381070,1291381077,394,7
2624,1291380676,1291381085,1291381091,409,6
2625,1291380676,1291381085,1291381090,409,5
2626,1291380676,1291381085,1291381091,409,6
2627,1291380676,1291381085,1291381090,409,5
2628,1291380734,1291381085,1291381089,351,4
2630,1291384769,1291384775,1291384776,6,1
2538,1291372867,1291372880,1291386828,13,13948
2634,1291387872,1291387880,1291387887,8,7
2635,1291387874,1291387880,1291387884,6,4
2636,1291387886,1291387895,1291387899,9,4
2637,1291388903,1291388915,1291388916,12,1
2638,1291389152,1291389155,1291389159,3,4
2643,1291389287,1291389290,1291389290,3,0
2644,1291389287,1291389290,1291389291,3,1
2645,1291389287,1291389290,1291389291,3,1
2646,1291389287,1291389290,1291389291,3,1
2647,1291389287,1291389290,1291389290,3,0
2648,1291389287,1291389290,1291389290,3,0
2649,1291389287,1291389290,1291389291,3,1
2650,1291389288,1291389290,1291389290,2,0
2651,1291389288,1291389290,1291389291,2,1
2652,1291389288,1291389290,1291389291,2,1
2653,1291389288,1291389290,1291389291,2,1
2654,1291389288,1291389290,1291389291,2,1
2655,1291389288,1291389290,1291389290,2,0
2656,1291389288,1291389290,1291389290,2,0
2657,1291389288,1291389290,1291389291,2,1
2658,1291389288,1291389290,1291389290,2,0
2659,1291389288,1291389290,1291389291,2,1
2660,1291389288,1291389290,1291389291,2,1
2661,1291389288,1291389290,1291389291,2,1
2662,1291389288,1291389290,1291389291,2,1
2639,1291389287,1291389290,1291389291,3,1
2640,1291389287,1291389290,1291389291,3,1
2641,1291389287,1291389290,1291389291,3,1
2642,1291389287,1291389290,1291389291,3,1
2663,1291389288,1291389350,1291389350,62,0
2664,1291389288,1291389350,1291389351,62,1
2665,1291389288,1291389350,1291389351,62,1
2666,1291389288,1291389350,1291389350,62,0
2667,1291389288,1291389365,1291389365,77,0
2668,1291389288,1291389365,1291389365,77,0
2669,1291389288,1291389365,1291389365,77,0
2670,1291389288,1291389365,1291389365,77,0
2671,1291389288,1291389365,1291389365,77,0
2672,1291389288,1291389365,1291389365,77,0
2673,1291389288,1291389365,1291389365,77,0
2674,1291389288,1291389365,1291389365,77,0
2675,1291389288,1291389365,1291389365,77,0
2676,1291389288,1291389365,1291389365,77,0
2677,1291389288,1291389365,1291389366,77,1
2678,1291389288,1291389365,1291389365,77,0
2679,1291389288,1291389365,1291389365,77,0
2680,1291389288,1291389365,1291389365,77,0
2681,1291389288,1291389365,1291389365,77,0
2690,1291392465,1291392470,1291392475,5,5
2691,1291392465,1291392470,1291392474,5,4
2692,1291392465,1291392470,1291392475,5,5
2693,1291392465,1291392470,1291392479,5,9
2694,1291392465,1291392470,1291392474,5,4
2695,1291392465,1291392470,1291392474,5,4
2696,1291392465,1291392470,1291392474,5,4
2697,1291392465,1291392470,1291392474,5,4
2698,1291392465,1291392470,1291392474,5,4
2699,1291392465,1291392470,1291392474,5,4
2700,1291392465,1291392470,1291392474,5,4
2701,1291392465,1291392470,1291392474,5,4
2702,1291392465,1291392470,1291392474,5,4
2703,1291392465,1291392470,1291392475,5,5
2704,1291392465,1291392470,1291392474,5,4
2705,1291392465,1291392470,1291392474,5,4
2682,1291392465,1291392470,1291392474,5,4
2683,1291392465,1291392470,1291392474,5,4
2684,1291392465,1291392470,1291392474,5,4
2685,1291392465,1291392470,1291392474,5,4
2686,1291392465,1291392470,1291392474,5,4
2687,1291392465,1291392470,1291392473,5,3
2688,1291392465,1291392470,1291392474,5,4
2689,1291392465,1291392470,1291392474,5,4
2706,1291392465,1291392515,1291392519,50,4
2707,1291392465,1291392515,1291392518,50,3
2708,1291392465,1291392515,1291392519,50,4
2709,1291392465,1291392515,1291392519,50,4
2710,1291392466,1291392515,1291392520,49,5
2711,1291392466,1291392515,1291392522,49,7
2712,1291392466,1291392515,1291392522,49,7
2713,1291392466,1291392515,1291392518,49,3
2714,1291392466,1291392530,1291392533,64,3
2715,1291392466,1291392530,1291392534,64,4
2716,1291392466,1291392530,1291392537,64,7
2717,1291392466,1291392530,1291392537,64,7
2718,1291392466,1291392530,1291392535,64,5
2719,1291392466,1291392530,1291392546,64,16
2720,1291392466,1291392530,1291392537,64,7
2721,1291392466,1291392530,1291392537,64,7
2722,1291392466,1291392530,1291392541,64,11
2723,1291392466,1291392530,1291392533,64,3
2724,1291392466,1291392530,1291392533,64,3
2725,1291392466,1291392530,1291392534,64,4
2726,1291392820,1291392830,1291392833,10,3
2727,1291392830,1291392845,1291392849,15,4
2728,1291393180,1291393190,1291393192,10,2
2729,1291393194,1291393205,1291393208,11,3
2730,1291393201,1291393205,1291393208,4,3
2731,1291393209,1291393220,1291393223,11,3
2732,1291393215,1291393220,1291393223,5,3
2537,1291372864,1291372865,1291406178,1,33313
2487,1291296034,1291296035,1291412576,1,116541
2446,1290935683,1290935695,1291417641,12,481946
2458,1290939465,1291417670,1291430298,478205,12628
2539,1291372870,1291372880,1291442449,10,69569
2744,1291455443,1291455455,1291459501,12,4046
2745,1291455446,1291455455,1291462603,9,7148
2743,1291455403,1291455410,1291462761,7,7351
2735,1291454438,1291454450,1291466541,12,12091
2747,1291470988,1291470995,1291470998,7,3
2750,1291471010,1291471025,1291471028,15,3
2751,1291471015,1291471025,1291471028,10,3
2752,1291471021,1291471025,1291471029,4,4
2748,1291470999,1291471010,1291471013,11,3
2749,1291471006,1291471010,1291471013,4,3
2736,1291454443,1291454450,1291474006,7,19556
2737,1291454450,1291454465,1291475852,15,21387
2741,1291454791,1291475870,1291475871,21079,1
2632,1291384945,1291384955,1291476110,10,91155
2738,1291454454,1291466585,1291478308,12131,11723
2631,1291384817,1291384820,1291478872,3,94052
2734,1291454433,1291454435,1291480370,2,25935
2733,1291454424,1291454435,1291485803,11,31368
2739,1291454459,1291474490,1291493255,20031,18765
2633,1291386731,1291386740,1291507900,9,121160
2740,1291454465,1291480458,1291517061,25993,36603
2629,1291384686,1291384700,1291528362,14,143662
2455,1290935740,1291034965,1291544627,99225,509662
2758,1291548763,1291548770,1291549971,7,1201
2757,1291548760,1291548770,1291563891,10,15121
2753,1291540740,1291540745,1291567751,5,27006
2754,1291540841,1291540850,1291568348,9,27498
2763,1291568318,1291568330,1291570693,12,2363
2761,1291568313,1291568315,1291572088,2,3773
2765,1291572042,1291572050,1291578454,8,6404
2760,1291556017,1291556030,1291583806,13,27776
2764,1291568320,1291568330,1291586163,10,17833
2469,1291194679,1291194685,1291595979,6,401294
2755,1291541622,1291541630,1291598164,8,56534
2759,1291556000,1291556015,1291603180,15,47165
2756,1291548757,1291548770,1291615603,13,66833
2742,1291454988,1291454990,1291616009,2,161019
2762,1291568315,1291568330,1291620562,15,52232
2782,1291629016,1291629020,1291629024,4,4
2783,1291629016,1291629020,1291629024,4,4
2784,1291629016,1291629020,1291629024,4,4
2785,1291629016,1291629020,1291629024,4,4
2786,1291629201,1291629215,1291629221,14,6
2789,1291629366,1291629380,1291629384,14,4
2790,1291629693,1291629695,1291629699,2,4
2791,1291629888,1291629890,1291629897,2,7
2792,1291630030,1291630040,1291630044,10,4
2793,1291630123,1291630130,1291630136,7,6
2794,1291630209,1291630220,1291630226,11,6
2795,1291630255,1291630265,1291630271,10,6
1484,1288957412,1288957429,1291630653,17,2673224
2798,1291630791,1291630805,1291630810,14,5
2799,1291630796,1291630805,1291630810,9,5
2800,1291630825,1291630835,1291630839,10,4
2801,1291630826,1291630835,1291630839,9,4
2802,1291630826,1291630835,1291630839,9,4
2803,1291630827,1291630835,1291630839,8,4
2804,1291630880,1291630895,1291630901,15,6
2805,1291631010,1291631015,1291631022,5,7
2807,1291631412,1291631421,1291631431,9,10
2808,1291631412,1291631421,1291631431,9,10
2809,1291631412,1291631421,1291631431,9,10
2810,1291631412,1291631421,1291631431,9,10
2823,1291631412,1291631420,1291631424,8,4
2824,1291631412,1291631420,1291631424,8,4
2825,1291631412,1291631420,1291631424,8,4
2826,1291631412,1291631420,1291631424,8,4
2819,1291631412,1291631420,1291631424,8,4
2820,1291631412,1291631420,1291631424,8,4
2821,1291631412,1291631420,1291631424,8,4
2822,1291631412,1291631420,1291631424,8,4
2815,1291631412,1291631420,1291631425,8,5
2816,1291631412,1291631420,1291631425,8,5
2817,1291631412,1291631420,1291631430,8,10
2818,1291631412,1291631420,1291631425,8,5
2811,1291631412,1291631420,1291631423,8,3
2812,1291631412,1291631420,1291631424,8,4
2813,1291631412,1291631420,1291631424,8,4
2814,1291631412,1291631420,1291631424,8,4
2827,1291631412,1291631466,1291631473,54,7
2828,1291631412,1291631466,1291631472,54,6
2829,1291631412,1291631466,1291631472,54,6
2830,1291631412,1291631466,1291631472,54,6
2831,1291631412,1291631480,1291631483,68,3
2832,1291631412,1291631480,1291631484,68,4
2833,1291631412,1291631480,1291631484,68,4
2834,1291631412,1291631480,1291631485,68,5
2835,1291631412,1291631480,1291631487,68,7
2836,1291631412,1291631480,1291631487,68,7
2837,1291631412,1291631480,1291631483,68,3
2838,1291631412,1291631480,1291631483,68,3
2839,1291631412,1291631495,1291631500,83,5
2840,1291631412,1291631495,1291631501,83,6
2841,1291631412,1291631495,1291631502,83,7
2842,1291631412,1291631495,1291631501,83,6
2843,1291631412,1291631510,1291631524,98,14
2844,1291631412,1291631510,1291631517,98,7
2845,1291631412,1291631510,1291631516,98,6
2846,1291631412,1291631510,1291631521,98,11
2847,1291631412,1291631511,1291631516,99,5
2848,1291631412,1291631511,1291631518,99,7
2849,1291631412,1291631511,1291631518,99,7
2852,1291632126,1291632140,1291632144,14,4
2797,1291630451,1291630460,1291644974,9,14514
2796,1291630447,1291630460,1291645146,13,14686
2853,1291634031,1291634045,1291649360,14,15315
2851,1291631828,1291631840,1291652379,12,20539
2858,1291636427,1291649390,1291654311,12963,4921
2857,1291636424,1291645175,1291655020,8751,9845
2850,1291631825,1291631840,1291655968,15,24128
2859,1291636430,1291652405,1291658559,15975,6154
2860,1291636433,1291654340,1291659253,17907,4913
2866,1291637047,1291659518,1291659518,22471,0
2868,1291641292,1291659590,1291659594,18298,4
2869,1291641292,1291659590,1291659594,18298,4
2870,1291641292,1291659635,1291659639,18343,4
2871,1291641292,1291659635,1291659639,18343,4
2872,1291641292,1291659680,1291659699,18388,19
2873,1291641292,1291659680,1291659698,18388,18
2874,1291641292,1291659710,1291659714,18418,4
2875,1291641292,1291659710,1291659714,18418,4
2876,1291641293,1291659755,1291659760,18462,5
2877,1291641293,1291659755,1291659760,18462,5
2878,1291641293,1291659800,1291659820,18507,20
2879,1291641293,1291659800,1291659824,18507,24
2880,1291641293,1291659830,1291659834,18537,4
2881,1291641293,1291659830,1291659834,18537,4
2867,1291639350,1291659590,1291659900,20240,310
2882,1291641293,1291659875,1291659880,18582,5
2883,1291641293,1291659875,1291659880,18582,5
2884,1291641293,1291659920,1291659924,18627,4
2885,1291641293,1291659920,1291659924,18627,4
2886,1291641293,1291659920,1291659923,18627,3
2887,1291641293,1291659920,1291659924,18627,4
2888,1291641293,1291659950,1291659954,18657,4
2889,1291641293,1291659950,1291659955,18657,5
2890,1291641293,1291659950,1291659954,18657,4
2891,1291641293,1291659950,1291659954,18657,4
2892,1291641293,1291659995,1291659999,18702,4
2893,1291641293,1291659995,1291659998,18702,3
2894,1291641293,1291659995,1291659998,18702,3
2895,1291641293,1291659995,1291659999,18702,4
2896,1291641293,1291660040,1291660045,18747,5
2897,1291641293,1291660040,1291660047,18747,7
2898,1291641293,1291660040,1291660047,18747,7
2899,1291641293,1291660040,1291660043,18747,3
2900,1291641293,1291660070,1291660073,18777,3
2901,1291641293,1291660070,1291660075,18777,5
2902,1291641293,1291660070,1291660076,18777,6
2903,1291641293,1291660070,1291660077,18777,7
2904,1291641293,1291660115,1291660120,18822,5
2905,1291641293,1291660115,1291660131,18822,16
2906,1291641293,1291660115,1291660122,18822,7
2907,1291641293,1291660115,1291660122,18822,7
2908,1291641293,1291660160,1291660172,18867,12
2909,1291641293,1291660160,1291660163,18867,3
2910,1291641293,1291660160,1291660164,18867,4
2911,1291641293,1291660160,1291660164,18867,4
2916,1291659245,1291660190,1291660193,945,3
2917,1291659414,1291660190,1291660193,776,3
2419,1290768842,1290874390,1291660233,105548,785843
2918,1291660384,1291660385,1291660389,1,4
2919,1291660438,1291660445,1291660449,7,4
2920,1291660500,1291660505,1291660509,5,4
2921,1291660669,1291660670,1291660671,1,1
2922,1291660692,1291660700,1291660704,8,4
2923,1291660692,1291660700,1291660704,8,4
2924,1291660692,1291660700,1291660704,8,4
2925,1291660692,1291660700,1291660704,8,4
2926,1291660692,1291660700,1291660704,8,4
2927,1291660692,1291660700,1291660704,8,4
2966,1291660735,1291660760,1291660766,25,6
2928,1291660692,1291660760,1291660764,68,4
2929,1291660692,1291660760,1291660764,68,4
2930,1291660692,1291660760,1291660764,68,4
2931,1291660692,1291660760,1291660764,68,4
2932,1291660692,1291660760,1291660764,68,4
2933,1291660692,1291660760,1291660769,68,9
2934,1291660692,1291660790,1291660794,98,4
2935,1291660693,1291660790,1291660794,97,4
2936,1291660693,1291660790,1291660794,97,4
2937,1291660693,1291660790,1291660794,97,4
2938,1291660693,1291660790,1291660794,97,4
2939,1291660693,1291660790,1291660794,97,4
2940,1291660693,1291660790,1291660794,97,4
2941,1291660693,1291660790,1291660794,97,4
2967,1291660815,1291660835,1291660839,20,4
2942,1291660693,1291660835,1291660839,142,4
2943,1291660693,1291660835,1291660840,142,5
2944,1291660693,1291660835,1291660839,142,4
2945,1291660693,1291660835,1291660839,142,4
2946,1291660693,1291660835,1291660839,142,4
2947,1291660693,1291660835,1291660839,142,4
2956,1291660693,1291660880,1291660886,187,6
2957,1291660693,1291660880,1291660884,187,4
2958,1291660693,1291660880,1291660886,187,6
2959,1291660693,1291660880,1291660896,187,16
2960,1291660693,1291660880,1291660887,187,7
2961,1291660693,1291660880,1291660884,187,4
2962,1291660693,1291660880,1291660892,187,12
2963,1291660693,1291660880,1291660884,187,4
2948,1291660693,1291660865,1291660871,172,6
2949,1291660693,1291660865,1291660871,172,6
2950,1291660693,1291660865,1291660872,172,7
2951,1291660693,1291660865,1291660873,172,8
2952,1291660693,1291660865,1291660874,172,9
2953,1291660693,1291660865,1291660870,172,5
2954,1291660693,1291660865,1291660870,172,5
2955,1291660693,1291660865,1291660871,172,6
2964,1291660693,1291660910,1291660915,217,5
2965,1291660693,1291660910,1291660914,217,4
2968,1291661129,1291661135,1291661140,6,5
2969,1291661315,1291661330,1291661334,15,4
2970,1291661665,1291661675,1291661679,10,4
2971,1291661902,1291661915,1291661919,13,4
2972,1291661905,1291661915,1291661920,10,5
2864,1291636445,1291659260,1291663793,22815,4533
2863,1291636442,1291658600,1291664247,22158,5647
2862,1291636439,1291656005,1291664767,19566,8762
2861,1291636436,1291655060,1291668209,18624,13149
2774,1291628142,1291628150,1291669375,8,41225
2912,1291643164,1291669400,1291669401,26236,1
2856,1291635965,1291645010,1291675106,9045,30096
2470,1291194756,1291194760,1291686437,4,491677
2490,1291372152,1291372160,1291689112,8,316952
2771,1291620672,1291620680,1291689286,8,68606
1648,1289719647,1289719652,1291695684,5,1976032
2854,1291634120,1291634138,1291703551,18,69413
2772,1291627471,1291630790,1291706917,3319,76127
2769,1291620407,1291620410,1291709590,3,89180
3001,1291713667,1291713684,1291713693,17,9
3002,1291713667,1291713684,1291713696,17,12
3003,1291713667,1291713684,1291713697,17,13
3004,1291713667,1291713684,1291713690,17,6
2993,1291713667,1291713680,1291713684,13,4
2994,1291713667,1291713680,1291713685,13,5
2995,1291713667,1291713680,1291713684,13,4
2996,1291713667,1291713680,1291713684,13,4
2997,1291713667,1291713680,1291713685,13,5
2998,1291713667,1291713680,1291713684,13,4
2999,1291713667,1291713680,1291713685,13,5
3000,1291713667,1291713680,1291713685,13,5
2989,1291713667,1291713680,1291713684,13,4
2990,1291713667,1291713680,1291713684,13,4
2991,1291713667,1291713680,1291713684,13,4
2992,1291713667,1291713680,1291713684,13,4
2977,1291713666,1291713680,1291713684,14,4
2978,1291713666,1291713680,1291713683,14,3
2979,1291713666,1291713680,1291713684,14,4
2980,1291713666,1291713680,1291713684,14,4
2973,1291713666,1291713680,1291713685,14,5
2974,1291713666,1291713680,1291713685,14,5
2975,1291713666,1291713680,1291713685,14,5
2976,1291713666,1291713680,1291713685,14,5
2981,1291713666,1291713680,1291713685,14,5
2982,1291713666,1291713680,1291713685,14,5
2983,1291713666,1291713680,1291713685,14,5
2984,1291713667,1291713680,1291713689,13,9
2985,1291713667,1291713680,1291713685,13,5
2986,1291713667,1291713680,1291713685,13,5
2987,1291713667,1291713680,1291713684,13,4
2988,1291713667,1291713680,1291713684,13,4
3005,1291713667,1291713741,1291713746,74,5
3006,1291713667,1291713741,1291713748,74,7
3007,1291713667,1291713741,1291713753,74,12
3008,1291713667,1291713741,1291713753,74,12
3009,1291713667,1291713740,1291713745,73,5
3010,1291713667,1291713740,1291713756,73,16
3011,1291713667,1291713740,1291713747,73,7
3012,1291713667,1291713740,1291713747,73,7
3013,1291713667,1291713740,1291713751,73,11
3014,1291713667,1291713740,1291713743,73,3
3015,1291713667,1291713740,1291713743,73,3
3016,1291713667,1291713740,1291713744,73,4
3018,1291715110,1291715120,1291715121,10,1
3019,1291716306,1291716320,1291716321,14,1
3023,1291719138,1291719140,1291719143,2,3
3024,1291720007,1291720010,1291720013,3,3
3025,1291720800,1291720808,1291720813,8,5
3020,1291716366,1291716380,1291722984,14,6604
2773,1291627951,1291689155,1291723564,61204,34409
2767,1291620262,1291620275,1291723661,13,103386
2855,1291635803,1291635815,1291740226,12,104411
2865,1291636640,1291663820,1291748756,27180,84936
2777,1291628434,1291723595,1291750170,95161,26575
2766,1291572326,1291572335,1291788909,9,216574
3026,1291794768,1291794770,1291794771,2,1
3027,1291795566,1291795580,1291795585,14,5
3032,1291800256,1291800260,1291800264,4,4
3034,1291813349,1291813355,1291813555,6,200
3021,1291716420,1291716425,1291814144,5,97719
2768,1291620313,1291620320,1291815822,7,195502
3017,1291713877,1291713890,1291816821,13,102931
2776,1291628278,1291706945,1291819375,78667,112430
3028,1291798127,1291798130,1291833514,3,35384
3037,1291813828,1291813835,1291836666,7,22831
2770,1291620434,1291620440,1291842181,6,221741
2806,1291631135,1291631150,1291858764,15,227614
2788,1291629361,1291629365,1291862369,4,233004
3031,1291798729,1291798730,1291864741,1,66011
3036,1291813541,1291813551,1291865276,10,51725
2438,1290872596,1290872605,1291881820,9,1009215
3039,1291882164,1291882175,1291882262,11,87
3040,1291885193,1291885205,1291885252,12,47
3035,1291813421,1291813430,1291900121,9,86691
3033,1291812477,1291812488,1291934652,11,122164
3022,1291716495,1291716500,1291949157,5,232657
2915,1291643478,1291689305,1291968267,45827,278962
2914,1291643384,1291686455,1291980421,43071,293966
3041,1291977986,1291977995,1291981676,9,3681
3050,1291981700,1291981715,1291981716,15,1
3038,1291881894,1291881905,1291993024,11,111119
3068,1291996612,1291996625,1291996630,13,5
3069,1291996612,1291996625,1291996630,13,5
3070,1291996612,1291996625,1291996630,13,5
3071,1291996612,1291996625,1291996630,13,5
3072,1291996612,1291996625,1291996630,13,5
3073,1291996612,1291996625,1291996631,13,6
3074,1291996612,1291996625,1291996629,13,4
3075,1291996612,1291996625,1291996630,13,5
3092,1291996613,1291996625,1291996637,12,12
3093,1291996613,1291996625,1291996629,12,4
3094,1291996613,1291996625,1291996630,12,5
3095,1291996613,1291996625,1291996629,12,4
3084,1291996612,1291996626,1291996630,14,4
3085,1291996612,1291996626,1291996631,14,5
3086,1291996612,1291996626,1291996633,14,7
3087,1291996612,1291996626,1291996630,14,4
3088,1291996613,1291996626,1291996632,13,6
3089,1291996613,1291996625,1291996643,12,18
3090,1291996613,1291996626,1291996634,13,8
3091,1291996613,1291996626,1291996630,13,4
3060,1291996612,1291996625,1291996630,13,5
3061,1291996612,1291996625,1291996630,13,5
3062,1291996612,1291996625,1291996630,13,5
3063,1291996612,1291996625,1291996634,13,9
3064,1291996612,1291996625,1291996630,13,5
3065,1291996612,1291996625,1291996630,13,5
3066,1291996612,1291996625,1291996630,13,5
3067,1291996612,1291996625,1291996630,13,5
3052,1291996612,1291996625,1291996630,13,5
3053,1291996612,1291996625,1291996630,13,5
3054,1291996612,1291996625,1291996630,13,5
3055,1291996612,1291996625,1291996630,13,5
3056,1291996612,1291996625,1291996630,13,5
3057,1291996612,1291996625,1291996630,13,5
3058,1291996612,1291996625,1291996630,13,5
3059,1291996612,1291996625,1291996630,13,5
3076,1291996612,1291996626,1291996632,14,6
3077,1291996612,1291996626,1291996632,14,6
3078,1291996612,1291996626,1291996632,14,6
3079,1291996612,1291996626,1291996632,14,6
3080,1291996612,1291996626,1291996633,14,7
3081,1291996612,1291996626,1291996634,14,8
3082,1291996612,1291996626,1291996635,14,9
3083,1291996612,1291996626,1291996631,14,5
3045,1291980697,1291980710,1292001864,13,21154
2913,1291643320,1291669445,1292030679,26125,361234
3043,1291978229,1291978235,1292032550,6,54315
3042,1291978167,1291978175,1292033807,8,55632
3046,1291980735,1291980740,1292042095,5,61355
3096,1292063706,1292063720,1292063724,14,4
3098,1292063741,1292063750,1292063754,9,4
3099,1292063749,1292063750,1292063754,1,4
3097,1292063732,1292063735,1292063740,3,5
3100,1292063753,1292063765,1292063769,12,4
3101,1292063762,1292063765,1292063769,3,4
3102,1292063766,1292063780,1292063784,14,4
3103,1292063770,1292063780,1292063781,10,1
3104,1292063773,1292063780,1292063784,7,4
3105,1292063777,1292063780,1292063784,3,4
3106,1292063779,1292063780,1292063784,1,4
3111,1292063795,1292063810,1292063814,15,4
3112,1292063799,1292063810,1292063814,11,4
3113,1292063802,1292063810,1292063814,8,4
3107,1292063782,1292063795,1292063802,13,7
3108,1292063785,1292063795,1292063799,10,4
3109,1292063788,1292063795,1292063799,7,4
3110,1292063792,1292063795,1292063799,3,4
3114,1292063805,1292063810,1292063814,5,4
3115,1292063809,1292063810,1292063814,1,4
3116,1292063812,1292063825,1292063829,13,4
3117,1292063817,1292063825,1292063829,8,4
3121,1292063827,1292063840,1292063844,13,4
3122,1292063830,1292063840,1292063844,10,4
3123,1292063833,1292063840,1292063844,7,4
3124,1292063836,1292063840,1292063844,4,4
3125,1292063838,1292063840,1292063845,2,5
3126,1292063841,1292063855,1292063861,14,6
3127,1292063842,1292063855,1292063861,13,6
3128,1292063845,1292063855,1292063859,10,4
3129,1292063848,1292063855,1292063859,7,4
3130,1292063851,1292063855,1292063859,4,4
3131,1292063862,1292063870,1292063876,8,6
3132,1292063865,1292063870,1292063876,5,6
3133,1292063868,1292063870,1292063874,2,4
3118,1292063819,1292063825,1292063830,6,5
3119,1292063821,1292063825,1292063829,4,4
3120,1292063824,1292063825,1292063829,1,4
3134,1292063870,1292063885,1292063899,15,14
3135,1292063873,1292063885,1292063892,12,7
3136,1292063877,1292063885,1292063891,8,6
3137,1292063879,1292063885,1292063895,6,10
3138,1292063882,1292063885,1292063889,3,4
3139,1292063884,1292063885,1292063889,1,4
3140,1292063887,1292063900,1292063904,13,4
3142,1292065993,1292066000,1292066065,7,65
3141,1292065852,1292065865,1292066356,13,491
3145,1292066720,1292066735,1292066798,15,63
3048,1291981274,1291981280,1292067290,6,86010
3049,1291981310,1291981325,1292067312,15,85987
3047,1291980938,1291980950,1292069559,12,88609
3151,1292069923,1292069930,1292070557,7,627
3155,1292071807,1292071820,1292071821,13,1
3044,1291980433,1291980440,1292087051,7,106611
2775,1291628161,1291628165,1292088721,4,460556
3148,1292067301,1292067305,1292110555,4,43250
3143,1292066036,1292066045,1292113510,9,47465
3144,1292066713,1292066720,1292119763,7,53043
3157,1292144428,1292144435,1292144436,7,1
3160,1292145797,1292145800,1292145801,3,1
3161,1292146079,1292146085,1292148151,6,2066
3166,1292149332,0,0,-1292149332,0
3029,1291798608,1291798610,1292149550,2,350940
3164,1292149212,1292149220,1292153030,8,3810
3165,1292149286,1292149295,1292153309,9,4014
3150,1292068494,1292068505,1292179695,11,111190
3163,1292148985,1292148995,1292181047,10,32052
3156,1292144218,1292144225,1292182362,7,38137
3146,1292066844,1292066855,1292196332,11,129477
3158,1292144497,1292144510,1292202381,13,57871
3149,1292067341,1292067350,1292212621,9,145271
3171,1292180653,1292180660,1292230613,7,49953
3162,1292148353,1292148365,1292236034,12,87669
3152,1292071539,1292071550,1292287969,11,216419
3167,1292149580,1292149595,1292310816,15,161221
3173,1292409495,1292409500,1292409501,5,1
3174,1292415056,1292415065,1292416078,9,1013
3168,1292158477,1292158490,1292434167,13,275677
3176,1292416401,1292416415,1292454379,14,37964
3172,1292407698,1292407700,1292464415,2,56715
3178,1292416557,1292416565,1292478676,8,62111
2399,1290701445,1290701455,1292494422,10,1792967
3205,1292498292,1292498300,1292498306,8,6
3206,1292498293,1292498300,1292498305,7,5
3207,1292498293,1292498300,1292498305,7,5
3208,1292498293,1292498300,1292498305,7,5
3209,1292498293,1292498300,1292498306,7,6
3210,1292498293,1292498300,1292498308,7,8
3211,1292498293,1292498300,1292498308,7,8
3212,1292498293,1292498300,1292498305,7,5
3213,1292498293,1292498300,1292498305,7,5
3214,1292498293,1292498300,1292498306,7,6
3215,1292498293,1292498300,1292498307,7,7
3216,1292498293,1292498300,1292498305,7,5
3217,1292498293,1292498300,1292498307,7,7
3218,1292498293,1292498300,1292498317,7,17
3219,1292498293,1292498300,1292498309,7,9
3220,1292498293,1292498300,1292498305,7,5
3181,1292498292,1292498300,1292498304,8,4
3182,1292498292,1292498300,1292498304,8,4
3183,1292498292,1292498300,1292498304,8,4
3184,1292498292,1292498300,1292498304,8,4
3185,1292498292,1292498300,1292498304,8,4
3186,1292498292,1292498300,1292498304,8,4
3187,1292498292,1292498300,1292498304,8,4
3188,1292498292,1292498300,1292498304,8,4
3189,1292498292,1292498300,1292498305,8,5
3190,1292498292,1292498300,1292498305,8,5
3191,1292498292,1292498300,1292498305,8,5
3192,1292498292,1292498300,1292498309,8,9
3193,1292498292,1292498300,1292498305,8,5
3194,1292498292,1292498300,1292498305,8,5
3195,1292498292,1292498300,1292498305,8,5
3196,1292498292,1292498300,1292498305,8,5
3197,1292498292,1292498300,1292498305,8,5
3198,1292498292,1292498300,1292498305,8,5
3199,1292498292,1292498300,1292498305,8,5
3200,1292498292,1292498300,1292498305,8,5
3201,1292498292,1292498300,1292498305,8,5
3202,1292498292,1292498300,1292498306,8,6
3203,1292498292,1292498300,1292498305,8,5
3204,1292498292,1292498300,1292498305,8,5
3221,1292498293,1292498300,1292498311,7,11
3222,1292498293,1292498300,1292498305,7,5
3223,1292498293,1292498300,1292498306,7,6
3224,1292498293,1292498300,1292498305,7,5
3225,1292500514,1292500520,1292500524,6,4
3226,1292500515,1292500520,1292500524,5,4
3227,1292500516,1292500520,1292500525,4,5
3228,1292500960,1292500970,1292500974,10,4
3229,1292501090,1292501105,1292501109,15,4
3051,1291981813,1291981820,1292521234,7,539414
3170,1292158619,1292158625,1292523022,6,364397
3030,1291798611,1291798625,1292537889,14,739264
3180,1292490587,1292490590,1292600571,3,109981
3175,1292416218,1292416220,1292609348,2,193128
3236,1292602299,1292602310,1292614248,11,11938
3235,1292602286,1292602295,1292618257,9,15962
3234,1292602058,1292602070,1292625819,12,23749
3233,1292601606,1292601620,1292640828,14,39208
3153,1292071700,1292071715,1292664385,15,592670
3232,1292601466,1292601470,1292702028,4,100558
3238,1292748871,1292748875,1292751034,4,2159
3239,1292749652,1292749655,1292751387,3,1732
3240,1292750674,1292750675,1292752110,1,1435
3242,1292757838,1292757845,1292758885,7,1040
3241,1292757768,1292757770,1292759225,2,1455
3244,1292761311,1292761325,1292761325,14,0
3247,1292761530,1292761535,1292761713,5,178
3243,1292761308,1292761310,1292762759,2,1449
3245,1292761459,1292761460,1292765931,1,4471
3246,1292761474,1292761475,1292788500,1,27025
2437,1290872590,1290872605,1292841693,15,1969088
3256,1292841744,1292841755,1292841898,11,143
3252,1292841727,1292841740,1292841936,13,196
3255,1292841736,1292841740,1292841963,4,223
3248,1292841067,1292841080,1292841990,13,910
3257,1292841750,1292841755,1292842017,5,262
3251,1292841724,1292841725,1292842051,1,326
3249,1292841212,1292841215,1292842116,3,901
3259,1292841760,1292841770,1292842095,10,325
3254,1292841733,1292841740,1292842155,7,415
3253,1292841730,1292841741,1292842305,11,564
3250,1292841722,1292841725,1292842327,3,602
3258,1292841755,1292841771,1292850090,16,8319
2459,1290940480,1290940495,1292879155,15,1938660
3261,1292946283,1292946290,1292951430,7,5140
3263,1292946399,1292946410,1292961199,11,14789
3262,1292946392,1292946395,1292961857,3,15462
3260,1292946279,1292946290,1292965217,11,18927
3177,1292416478,1292416490,1292968016,12,551526
1423,1288351656,1288351727,1292985077,71,4633350
3272,1293094002,1293094010,1293094010,8,0
3270,1293093997,1293094010,1293099094,13,5084
3266,1293093984,1293093995,1293100501,11,6506
3283,1293098043,1293098045,1293101912,2,3867
3268,1293093989,1293093995,1293102455,6,8460
3289,1293098625,1293102485,1293102485,3860,0
3284,1293098046,1293098060,1293102644,14,4584
3290,1293098631,1293102515,1293103480,3884,965
3274,1293095680,1293095690,1293104014,10,8324
3287,1293098613,1293100550,1293104583,1937,4033
3269,1293093992,1293093995,1293104930,3,10935
3286,1293098610,1293098615,1293106585,5,7970
3288,1293098620,1293101960,1293106636,3340,4676
3271,1293093999,1293094010,1293107075,11,13065
3280,1293098033,1293098045,1293107040,12,8995
3267,1293093987,1293093995,1293108093,8,14098
3281,1293098036,1293098045,1293108365,9,10320
3279,1293098031,1293098045,1293112966,14,14921
3264,1293093838,1293093845,1293114123,7,20278
3285,1293098608,1293098616,1293114203,8,15587
3282,1293098039,1293098045,1293115946,6,17901
3273,1293094005,1293094010,1293122490,5,28480
3237,1292602612,1292602625,1293159433,13,556808
3292,1293164277,1293164285,1293164285,8,0
3291,1293162964,1293162965,1293164512,1,1547
3293,1293165558,1293165560,1293167422,2,1862
3296,1293168256,1293168260,1293169643,4,1383
3297,1293168784,1293168785,1293169899,1,1114
3298,1293168790,1293168800,1293170023,10,1223
3295,1293168251,1293168260,1293170731,9,2471
3300,1293169172,1293169175,1293170787,3,1612
3309,1293170386,1293170390,1293170971,4,581
3302,1293169451,1293169460,1293171052,9,1592
3294,1293167074,1293167075,1293171123,1,4048
3304,1293170371,1293170375,1293171142,4,767
3299,1293169164,1293169175,1293171149,11,1974
3305,1293170374,1293170375,1293171170,1,795
3308,1293170383,1293170390,1293171224,7,834
3311,1293170392,1293170405,1293171284,13,879
3307,1293170380,1293170390,1293171327,10,937
3313,1293170969,1293170975,1293171548,6,573
3306,1293170377,1293170390,1293171643,13,1253
3303,1293169455,1293169460,1293171782,5,2322
3310,1293170389,1293170390,1293171995,1,1605
3314,1293171003,1293171005,1293172318,2,1313
3301,1293169448,1293169460,1293172956,12,3496
3323,1293172253,1293172265,1293173975,12,1710
3324,1293172519,1293172520,1293176926,1,4406
3326,1293175414,1293175415,1293177199,1,1784
3265,1293093981,1293093995,1293177796,14,83801
3312,1293170684,1293170690,1293187161,6,16471
3331,1293184379,1293184385,1293188738,6,4353
3321,1293171406,1293171410,1293192493,4,21083
3332,1293184397,1293184400,1293196695,3,12295
3276,1293095704,1293095706,1293201144,2,105438
3320,1293171403,1293171410,1293202941,7,31531
3319,1293171401,1293171410,1293206391,9,34981
3316,1293171392,1293171395,1293207691,3,36296
3318,1293171398,1293171410,1293215749,12,44339
3322,1293171408,1293171410,1293220305,2,48895
3317,1293171395,1293171410,1293223863,15,52453
3179,1292416568,1292416580,1293244733,12,828153
3315,1293171389,1293171395,1293248666,6,77271
3278,1293095712,1293099140,1293329230,3428,230090
3338,1293342841,1293342845,1293347709,4,4864
3334,1293342755,1293342770,1293356700,15,13930
3335,1293342758,1293342770,1293360899,12,18129
3325,1293172841,1293172880,1293366861,39,193981
3330,1293176304,1293177830,1293393981,1526,216151
3340,1293423514,1293423515,1293428705,1,5190
3342,1293423520,1293423530,1293429386,10,5856
3339,1293423510,1293423515,1293433373,5,9858
3337,1293342768,1293342770,1293433505,2,90735
3341,1293423517,1293423530,1293439494,13,15964
3345,1293448045,1293448055,1293449024,10,969
3349,1293449015,1293449030,1293449035,15,5
3346,1293448994,1293449000,1293449082,6,82
3347,1293449002,1293449015,1293449030,13,15
3344,1293447855,1293447860,1293450005,5,2145
3356,1293449773,1293449780,1293453317,7,3537
3355,1293449770,1293449780,1293453851,10,4071
3350,1293449549,1293449555,1293454512,6,4957
3336,1293342764,1293342770,1293455519,6,112749
3353,1293449765,1293449780,1293472155,15,22375
3352,1293449763,1293449765,1293472888,2,23123
3154,1292071756,1292071760,1293476418,4,1404658
3348,1293449007,1293449015,1293483194,8,34179
3275,1293095700,1293095705,1293488284,5,392579
3358,1293505411,1293505415,1293505593,4,178
3351,1293449759,1293449765,1293505662,6,55897
3363,1293506882,1293506885,1293506889,3,4
3364,1293506988,1293506990,1293506994,2,4
3366,1293507105,1293507110,1293507115,5,5
3365,1293507055,1293507065,1293507145,10,80
3360,1293506259,1293506270,1293507260,11,990
3367,1293507185,1293507200,1293507280,15,80
3368,1293507282,1293507290,1293507361,8,71
3369,1293508075,1293508085,1293508125,10,40
3372,1293508098,1293508100,1293508145,2,45
3370,1293508084,1293508085,1293508170,1,85
3361,1293506377,1293506390,1293508443,13,2053
3362,1293506480,1293506495,1293508896,15,2401
3359,1293506000,1293506015,1293510385,15,4370
3371,1293508090,1293508100,1293546357,10,38257
3357,1293460158,1293460160,1293569086,2,108926
3329,1293176280,1293177230,1293570192,950,392962
3169,1292158561,1292158565,1293571625,4,1413060
3277,1293095708,1293095721,1293591669,13,495948
3354,1293449768,1293449780,1293596852,12,147072
3230,1292584593,1292584595,1293615700,2,1031105
3374,1293622535,1293622552,1293622553,17,1
3378,1293622545,1293622550,1293622550,5,0
3379,1293622548,1293622550,1293622550,2,0
3380,1293622550,1293622565,1293622566,15,1
3375,1293622538,1293622550,1293622552,12,2
3383,1293622610,1293622625,1293622625,15,0
3377,1293622543,1293622550,1293633629,7,11079
3382,1293622555,1293622565,1293634072,10,11507
3384,1293680271,1293680285,1293680291,14,6
3373,1293622533,1293622535,1293680810,2,58275
3398,1293683545,1293683555,1293683556,10,1
3395,1293681659,1293681665,1293685716,6,4051
3397,1293682074,1293682085,1293685917,11,3832
3394,1293681539,1293681545,1293687598,6,6053
3385,1293680429,1293680435,1293688439,6,8004
3393,1293681304,1293681305,1293688484,1,7179
3396,1293681960,1293681965,1293689177,5,7212
3399,1293692531,1293692540,1293692545,9,5
3400,1293692727,1293692735,1293694040,8,1305
3401,1293695770,1293695780,1293695781,10,1
3391,1293681297,1293681305,1293700986,8,19681
3376,1293622540,1293622550,1293729684,10,107134
3328,1293176068,1293176075,1293752487,7,576412
3402,1293758356,1293758360,1293758361,4,1
3408,1293761550,1293761555,1293761555,5,0
3410,1293764186,1293764195,1293764196,9,1
3388,1293681166,1293681170,1293796376,4,115206
3411,1293796929,1293796940,1293798882,11,1942
3409,1293761704,1293761705,1293799981,1,38276
3412,1293797160,1293797166,1293803017,6,5851
3404,1293759227,1293759230,1293803464,3,44234
3386,1293680576,1293680585,1293812841,9,132256
3387,1293681153,1293681155,1293835609,2,154454
3147,1292066955,1292066963,1293844283,8,1777320
3419,1293849883,1293849890,1293854050,7,4160
3407,1293759737,1293759740,1293857495,3,97755
3415,1293848178,1293848180,1293862028,2,13848
3381,1293622553,1293622565,1293871188,12,248623
3418,1293849867,1293849875,1293882505,8,32630
3417,1293849848,1293849860,1293884878,12,35018
3403,1293758662,1293758675,1293902473,13,143798
3390,1293681195,1293681200,1293921989,5,240789
3413,1293848087,1293848092,1293950393,5,102301
3416,1293849449,1293849455,1293959437,6,109982
3389,1293681187,1293681200,1294087609,13,406409
3231,1292600945,1292600960,1294196815,15,1595855
3425,1294216691,1294216700,1294216740,9,40
3426,1294217263,1294217271,1294288553,8,71282
3427,1294217623,1294217631,1294301186,8,83555
3392,1293681301,1293681305,1294303538,4,622233
2402,1290755877,1290755890,1294346579,13,3590689
3430,1294443261,1294443277,1294443277,16,0
3423,1293850659,1293850670,1294444598,11,593928
3434,1294443432,1294443440,1294449827,8,6387
3429,1294443252,1294443262,1294457924,10,14662
3431,1294443378,1294443380,1294460028,2,16648
3433,1294443387,1294443395,1294461933,8,18538
3432,1294443382,1294443395,1294471691,13,28296
3405,1293759532,1293759545,1294473445,13,713900
3421,1293850400,1293850415,1294480257,15,629842
3422,1293850561,1293850565,1294518336,4,667771
3424,1293850804,1293850805,1294601059,1,750254
3444,1294606110,1294606115,1294606115,5,0
3445,1294606116,1294606130,1294606130,14,0
3443,1294606105,1294606119,1294606120,14,1
3446,1294606120,1294606130,1294606130,10,0
3438,1294606090,1294606100,1294619736,10,13636
3448,1294606429,1294606430,1294623572,1,17142
3437,1294606085,1294606103,1294633568,18,27465
3452,1294606510,1294606520,1294637735,10,31215
3447,1294606426,1294606430,1294639912,4,33482
3441,1294606100,1294606115,1294655890,15,49775
3436,1294606082,1294606087,1294660916,5,54829
3451,1294606503,1294606505,1294663243,2,56738
3439,1294606093,1294606100,1294695593,7,89493
3442,1294606101,1294606115,1294705417,14,99302
3159,1292145523,1292145530,1294709344,7,2563814
3440,1294606096,1294606100,1294711032,4,104932
3450,1294606495,1294606505,1294711214,10,104709
3449,1294606439,1294606445,1294719999,6,113554
3453,1294606573,1294709375,1294757172,102802,47797
3456,1294607059,1294607060,1294771401,1,164341
3454,1294606594,1294757226,1294815454,150632,58228
3455,1294606622,1294815471,1294873024,208849,57553
3459,1294891286,1294891295,1294897832,9,6537
3435,1294443883,1294443890,1294924072,7,480182
3465,1294975919,1294975925,1294975972,6,47
3466,1294976049,1294976060,1294976095,11,35
3467,1294976957,1294976960,1294976964,3,4
3471,1294977466,1294977470,1294977483,4,13
3476,1294980892,1294980905,1294980905,13,0
3472,1294977492,1294977500,1294981534,8,4034
3473,1294977622,1294977635,1294982690,13,5055
3474,1294977639,1294977650,1294983896,11,6246
3478,1294981847,1294981850,1294984076,3,2226
3475,1294980884,1294980890,1294984662,6,3772
3477,1294981687,1294981700,1294984737,13,3037
3480,1294982000,1294982015,1294985150,15,3135
3460,1294891437,1294891445,1294986238,8,94793
3479,1294981855,1294981865,1294986334,10,4469
3484,1294982324,1294984775,1294987320,2451,2545
3482,1294982205,1294984085,1294987523,1880,3438
3486,1294982522,1294986350,1294988565,3828,2215
3485,1294982331,1294985165,1294990075,2834,4910
3470,1294977464,1294977470,1294990689,6,13219
3488,1294982683,1294987565,1294991313,4882,3748
3481,1294982010,1294983935,1294992471,1925,8536
3491,1294982819,1294990130,1294992843,7311,2713
3483,1294982217,1294984700,1294993801,2483,9101
3493,1294982929,1294991330,1294994095,8401,2765
3492,1294982826,1294990715,1294996793,7889,6078
3487,1294982570,1294987340,1294997316,4770,9976
3494,1294982936,1294992500,1294998512,9564,6012
3490,1294982705,1294988585,1294999404,5880,10819
3464,1294974817,1294974830,1295001951,13,27121
3461,1294974809,1294974830,1295003519,21,28689
3463,1294974815,1294974830,1295004793,15,29963
3462,1294974812,1294974816,1295019478,4,44662
3498,1295033554,1295033555,1295043053,1,9498
3496,1295033430,1295033437,1295043437,7,10000
3497,1295033489,1295033495,1295045712,6,12217
3499,1295033610,1295033615,1295048261,5,14646
3406,1293759610,1293759620,1295049171,10,1289551
3501,1295053751,1295053760,1295065561,9,11801
3495,1294991565,1294991570,1295082498,5,90928
3516,1295122259,1295122265,1295122266,6,1
3517,1295122404,1295122415,1295122710,11,295
3506,1295071328,1295071340,1295124370,12,53030
3515,1295121844,1295124410,1295124410,2566,0
3327,1293176013,1293176015,1295127590,2,1951575
2127,1290006908,1290136617,1295127659,129709,4991042
3333,1293342750,1293342755,1295127694,5,1784939
3457,1294607136,1294873070,1295127730,265934,254660
3520,1295123500,1295127742,1295127845,4242,103
3527,1295128131,1295128145,1295128145,14,0
3514,1295121764,1295121770,1295129074,6,7304
3524,1295127817,1295127860,1295129430,43,1570
3525,1295128030,1295129090,1295133887,1060,4797
3526,1295128042,1295129465,1295141382,1423,11917
3509,1295071343,1295071355,1295150662,12,79307
3503,1295070819,1295070849,1295151478,30,80629
3528,1295148249,1295148260,1295151774,11,3514
3505,1295071325,1295071340,1295161044,15,89704
3530,1295149876,1295150705,1295162956,829,12251
3529,1295148262,1295148275,1295165432,13,17157
3510,1295071347,1295071355,1295182139,8,110784
3507,1295071332,1295071340,1295186676,8,115336
3502,1295070790,1295070800,1295201739,10,130939
3511,1295118371,1295118380,1295203713,9,85333
3532,1295198872,1295201780,1295209415,2908,7635
3535,1295216562,1295216570,1295217286,8,716
3545,1295218462,1295218475,1295218480,13,5
3537,1295217223,1295217230,1295218864,7,1634
3542,1295217890,1295217905,1295219154,15,1249
3538,1295217405,1295217410,1295219213,5,1803
3543,1295218214,1295218220,1295219276,6,1056
3536,1295216598,1295216600,1295219344,2,2744
3540,1295217619,1295217621,1295220776,2,3155
3533,1295204351,1295204360,1295221251,9,16891
3534,1295204370,1295204375,1295221334,5,16959
3546,1295219575,1295219585,1295221377,10,1792
3547,1295220696,1295220710,1295222565,14,1855
3553,1295222592,1295222600,1295222657,8,57
3555,1295223235,1295223245,1295223299,10,54
3541,1295217734,1295217740,1295223352,6,5612
3539,1295217494,1295217500,1295223718,6,6218
3560,1295224466,1295224476,1295224481,10,5
3550,1295222104,1295222105,1295224525,1,2420
3563,1295224875,1295224880,1295224911,5,31
3548,1295221610,1295221625,1295225926,15,4301
3508,1295071340,1295071355,1295226052,15,154697
3504,1295070839,1295070845,1295226926,6,156081
3552,1295222391,1295222405,1295229542,14,7137
3561,1295224575,1295224580,1295229786,5,5206
3551,1295222194,1295222195,1295229952,1,7757
3562,1295224744,1295224745,1295230447,1,5702
3521,1295123505,1295127771,1295230894,4266,103123
3564,1295224995,1295225000,1295231071,5,6071
3554,1295223108,1295223110,1295233946,2,10836
3557,1295223437,1295223440,1295234765,3,11325
3567,1295236081,1295236085,1295236091,4,6
3565,1295225519,1295225525,1295236343,6,10818
3556,1295223344,1295223350,1295237802,6,14452
3549,1295221951,1295221955,1295244302,4,22347
3558,1295223560,1295223576,1295248191,16,24615
3544,1295218324,1295218325,1295248245,1,29920
3573,1295238815,1295238830,1295255945,15,17115
3559,1295223647,1295223650,1295291724,3,68074
3566,1295225637,1295225960,1295292153,323,66193
3518,1295123022,1295124455,1295293693,1433,169238
3579,1295290533,1295290535,1295295791,2,5256
3581,1295290663,1295291765,1295299164,1102,7399
3584,1295290758,1295295830,1295300764,5072,4934
3582,1295290670,1295292170,1295304743,1500,12573
3595,1295291460,1295291465,1295305557,5,14092
3587,1295290835,1295305040,1295311790,14205,6750
3585,1295290764,1295299205,1295312501,8441,13296
3578,1295268757,1295268770,1295311175,13,42405
3588,1295290944,1295311805,1295317699,20861,5894
3586,1295290832,1295300795,1295319711,9963,18916
3580,1295290551,1295290565,1295321012,14,30447
3568,1295236483,1295236490,1295321860,7,85370
3592,1295291145,1295321030,1295323681,29885,2651
3590,1295291063,1295317730,1295324149,26667,6419
3589,1295290952,1295312525,1295329940,21573,17415
3574,1295239013,1295248235,1295332696,9222,84461
3577,1295241048,1295332760,1295333489,91712,729
3583,1295290692,1295293745,1295334639,3053,40894
3531,1295152796,1295152806,1295337396,10,184590
3591,1295291069,1295320265,1295338239,29196,17974
3500,1295053663,1295313711,1295340733,260048,27022
3599,1295309485,1295330450,1295340817,20965,10367
3600,1295309558,1295334665,1295345449,25107,10784
3602,1295319135,1295338745,1295346141,19610,7396
3598,1295307805,1295324165,1295349853,16360,25688
3609,1295323790,1295340845,1295361737,17055,20892
3601,1295319131,1295337440,1295364151,18309,26711
3613,1295366303,1295366315,1295366679,12,364
3615,1295366563,1295366690,1295366690,127,0
3610,1295323877,1295345465,1295367959,21588,22494
3619,1295366732,1295367980,1295368027,1248,47
3620,1295366775,1295368070,1295368105,1295,35
3621,1295368879,1295368880,1295370316,1,1436
3571,1295237839,1295237840,1295391993,1,154153
3569,1295236757,1295236761,1295403954,4,167193
3596,1295291583,1295305580,1295414106,13997,108526
3594,1295291456,1295323715,1295459270,32259,135555
3622,1295372057,1295372060,1295464152,3,92092
3575,1295239224,1295256006,1295494485,16782,238479
3611,1295366162,1295366165,1295494765,3,128600
3624,1295373665,1295392025,1295514418,18360,122393
3612,1295366171,1295366180,1295527637,9,161457
3570,1295236939,1295236940,1295530463,1,293523
3512,1295120814,1295120825,1295543248,11,422423
3616,1295366566,1295366735,1295546847,169,180112
3572,1295238020,1295238035,1295549599,15,311564
3513,1295120883,1295120885,1295563715,2,442830
3617,1295366574,1295367278,1295572613,704,205335
3607,1295321881,1295340755,1295573958,18874,233203
3614,1295366554,1295366555,1295573989,1,207434
3618,1295366577,1295367324,1295573997,747,206673
3644,1295484341,1295546900,1295591407,62559,44507
3648,1295484352,1295574035,1295615733,89683,41698
3651,1295572672,1295615765,1295615765,43093,0
3643,1295484339,1295530505,1295631521,46166,101016
3653,1295572687,1295631545,1295631545,58858,0
3652,1295572680,1295615810,1295634297,43130,18487
3655,1295572953,1295634320,1295637602,61367,3282
3654,1295572946,1295631590,1295638190,58644,6600
3608,1295321885,1295340755,1295645635,18870,304880
3468,1294977043,1294977054,1295650513,11,673459
3642,1295484336,1295527685,1295652858,43349,125173
3645,1295484344,1295572640,1295656362,88296,83722
3649,1295484356,1295591450,1295664954,107094,73504
3628,1295374031,1295494824,1295666813,120793,171989
3664,1295581571,1295581580,1295674153,9,92573
3647,1295484350,1295574020,1295679299,89670,105279
3627,1295373812,1295494535,1295681532,120723,186997
3641,1295483344,1295514455,1295697321,31111,182866
3666,1295693212,1295693225,1295702609,13,9384
3668,1295693308,1295693315,1295705250,7,11935
3670,1295693386,1295693390,1295705319,4,11929
3671,1295693392,1295693405,1295706622,13,13217
3623,1295373607,1295392025,1295708862,18418,316837
3646,1295484347,1295573975,1295719569,89628,145594
3661,1295576038,1295719580,1295727404,143542,7824
3662,1295576055,1295727425,1295752638,151370,25213
3658,1295573896,1295645660,1295755042,71764,109382
3626,1295373762,1295464190,1295765089,90428,300899
3675,1295774703,1295774705,1295774865,2,160
3673,1295773966,1295773970,1295779517,4,5547
3656,1295572957,1295637650,1295779537,64693,141887
3663,1295576177,1295752657,1295781217,176480,28560
3674,1295774700,1295774705,1295783943,5,9238
3665,1295592772,1295755055,1295785419,162283,30364
3681,1295775177,1295779565,1295786434,4388,6869
3659,1295574277,1295652890,1295786928,78613,134038
3679,1295775054,1295775065,1295787352,11,12287
3672,1295773801,1295773805,1295791317,4,17512
3676,1295774885,1295774900,1295793368,15,18468
3683,1295775303,1295784260,1295793180,8957,8920
3680,1295775058,1295775065,1295793541,7,18476
3682,1295775181,1295779565,1295794534,4384,14969
3660,1295574298,1295656400,1295794555,82102,138155
3684,1295775308,1295786450,1295797818,11142,11368
3677,1295774906,1295774915,1295802318,9,27403
3669,1295693314,1295781306,1295812116,87992,30810
3678,1295774912,1295785460,1295814247,10548,28787
3698,1295794198,1295794205,1295815617,7,21412
3700,1295797827,1295797835,1295816293,8,18458
3687,1295776287,1295787365,1295818703,11078,31338
3689,1295777717,1295814260,1295835721,36543,21461
3686,1295776057,1295812145,1295840729,36088,28584
3690,1295777734,1295835786,1295855521,58052,19735
3696,1295790799,1295840750,1295856181,49951,15431
3657,1295573813,1295638235,1295858380,64422,220145
3576,1295239279,1295321915,1295862721,82636,540806
3699,1295797782,1295856230,1295872300,58448,16070
3697,1295794192,1295855555,1295877115,61363,21560
3713,1295968982,1295968985,1295971578,3,2593
3695,1295779798,1295793500,1295974229,13702,180729
3714,1295968986,1295971610,1295974654,2624,3044
3707,1295965558,1295965565,1295983611,7,18046
3716,1295968992,1295974700,1295984188,5708,9488
3717,1295968996,1295983655,1295985531,14659,1876
3691,1295778695,1295793380,1295987831,14685,194451
3718,1295968999,1295984210,1295990206,15211,5996
3688,1295776693,1295791355,1296011074,14662,219719
3625,1295373753,1295459287,1296016645,85534,557358
3469,1294977193,1294977200,1296018483,7,1041283
3719,1296032033,1296032047,1296040414,14,8367
3720,1296032038,1296032045,1296040411,7,8366
3723,1296038598,1296040431,1296051048,1833,10617
3722,1296038554,1296038555,1296051188,1,12633
3733,1296055253,1296055265,1296055285,12,20
3705,1295862922,1296016685,1296063391,153763,46706
3709,1295967062,1295967065,1296113513,3,146448
3737,1296090628,1296113540,1296113546,22912,6
3728,1296040315,1296113615,1296113616,73300,1
3729,1296040319,1296113660,1296113660,73341,0
3710,1295967080,1295967095,1296114863,15,147768
3708,1295966584,1295966585,1296136193,1,169608
3712,1295967191,1295967200,1296142687,9,175487
3739,1296124370,1296142715,1296142715,18345,0
3711,1295967182,1295967185,1296150289,3,183104
3741,1296129396,1296150320,1296150320,20924,0
3735,1296090417,1296090425,1296167486,8,77061
3685,1295775738,1295786975,1296169363,11237,382388
3734,1296090291,1296090306,1296203899,15,113593
3721,1296037979,1296037985,1296205736,6,167751
3519,1295123497,1295127690,1296257703,4193,1130013
3732,1296042054,1296257753,1296257760,215699,7
3745,1296298110,1296298120,1296298129,10,9
3746,1296298113,1296298192,1296298199,79,7
3747,1296298167,1296298237,1296298244,70,7
3730,1296041516,1296113705,1296304307,72189,190602
3754,1296308062,1296308075,1296313989,13,5914
3726,1296040041,1296051230,1296329052,11189,277822
3738,1296124367,1296136220,1296331060,11853,194840
3736,1296090518,1296090532,1296357076,14,266544
3757,1296377232,1296377240,1296377856,8,616
3758,1296377236,1296377240,1296377854,4,614
3743,1296201073,1296201080,1296378196,7,177116
3731,1296041524,1296114890,1296378805,73366,263915
3759,1296378112,1296378125,1296384391,13,6266
3756,1296374895,1296378830,1296398558,3935,19728
3755,1296374844,1296378245,1296398899,3401,20654
3775,1296405698,1296405710,1296406888,12,1178
3774,1296405688,1296405696,1296408712,8,3016
3724,1296039946,1296040460,1296424214,514,383754
3725,1296039956,1296051080,1296425382,11124,374302
3752,1296307929,1296425435,1296456610,117506,31175
3740,1296129392,1296142745,1296471693,13353,328948
3744,1296201076,1296205760,1296508420,4684,302660
3766,1296379829,1296424235,1296537493,44406,113258
3777,1296470502,1296470510,1296561523,8,91013
3770,1296380145,1296537515,1296564871,157370,27356
3765,1296379826,1296398930,1296606277,19104,207347
3772,1296405506,1296606290,1296612643,200784,6353
3773,1296405514,1296612650,1296618980,207136,6330
3597,1295306038,1295333555,1296621144,27517,1287589
3778,1296549524,1296621200,1296625345,71676,4145
3780,1296573105,1296625370,1296631289,52265,5919
3751,1296298998,1296331070,1296634245,32072,303175
3781,1296573109,1296631340,1296637005,58231,5665
3767,1296379831,1296457790,1296640999,77959,183209
3782,1296634137,1296634280,1296641627,143,7347
3789,1296643319,1296643325,1296643326,6,1
3788,1296643313,1296643325,1296643326,12,1
3790,1296643337,1296643340,1296643341,3,1
3783,1296634141,1296637010,1296644048,2869,7038
3785,1296634526,1296641045,1296648091,6519,7046
3791,1296658163,1296658175,1296658176,12,1
3792,1296658223,1296658235,1296658236,12,1
3779,1296563058,1296563060,1296672197,2,109137
3750,1296298423,1296329075,1296673314,30652,344239
3749,1296298394,1296304325,1296701106,5931,396781
3794,1296723181,1296723185,1296723539,4,354
3799,1296724578,1296724581,1296725113,3,532
3802,1296725206,1296725210,1296725211,4,1
3803,1296725284,1296725285,1296725286,1,1
3808,1296727755,1296727760,1296727760,5,0
3806,1296727750,1296727760,1296727760,10,0
3809,1296727758,1296727760,1296727760,2,0
3807,1296727753,1296727761,1296727761,8,0
3797,1296724043,1296724055,1296728461,12,4406
3796,1296723619,1296723620,1296729619,1,5999
3795,1296723555,1296723560,1296732728,5,9168
3798,1296724372,1296724385,1296733106,13,8721
3801,1296725201,1296725210,1296738301,9,13091
3811,1296734657,1296734660,1296741757,3,7097
3776,1296464598,1296619010,1296742369,154412,123359
3769,1296380142,1296508445,1296746182,128303,237737
3810,1296734652,1296734660,1296748086,8,13426
3813,1296734979,1296734990,1296754128,11,19138
3812,1296734878,1296734885,1296754226,7,19341
3805,1296725801,1296725810,1296759659,9,33849
3764,1296379824,1296398585,1296781635,18761,383050
3771,1296380148,1296564875,1296781689,184727,216814
3820,1296794053,1296794060,1296794280,7,220
3821,1296794114,1296794120,1296796126,6,2006
3819,1296793996,1296794000,1296798590,4,4590
3814,1296793469,1296793475,1296800333,6,6858
3816,1296793709,1296793715,1296801939,6,8224
3815,1296793588,1296793595,1296803359,7,9764
3817,1296793789,1296793791,1296808270,2,14479
3818,1296793905,1296793910,1296810592,5,16682
3824,1296804866,1296804875,1296811546,9,6671
3828,1296805314,1296805325,1296814481,11,9156
3787,1296643085,1296643100,1296816554,15,173454
3833,1296817601,1296817610,1296817611,9,1
3827,1296805139,1296805145,1296818652,6,13507
3825,1296805028,1296805040,1296825158,12,20118
3826,1296805116,1296805130,1296826121,14,20991
3823,1296804860,1296804875,1296827000,15,22125
3768,1296380139,1296471725,1296855332,91586,383607
3836,1296863879,1296863885,1296866103,6,2218
3838,1296863885,1296866150,1296868698,2265,2548
3835,1296863876,1296863885,1296868700,9,4815
3837,1296863882,1296863885,1296869469,3,5584
3834,1296863482,1296863495,1296874514,13,11019
3842,1296863896,1296874550,1296876201,10654,1651
3840,1296863890,1296868745,1296877931,4855,9186
3844,1296863901,1296877940,1296879509,14039,1569
3843,1296863898,1296876230,1296881152,12332,4922
3831,1296807720,1296816575,1296886477,8855,69902
3822,1296804590,1296804605,1296887338,15,82733
3832,1296807723,1296819200,1296890196,11477,70996
3841,1296863893,1296869510,1296890665,5617,21155
3829,1296807713,1296811580,1296895150,3867,83570
3846,1296863906,1296881180,1296895261,17274,14081
3839,1296863888,1296868715,1296899775,4827,31060
3853,1296919850,1296919865,1296920165,15,300
3857,1296920418,1296920420,1296925305,2,4885
3850,1296919841,1296919850,1296925949,9,6099
3849,1296919836,1296919850,1296927375,14,7525
3856,1296920125,1296920135,1296932215,10,12080
3852,1296919847,1296919850,1296935124,3,15274
3851,1296919844,1296919850,1296940330,6,20480
3855,1296919969,1296919970,1296958112,1,38142
3858,1296920529,1296920540,1296996554,11,76014
3854,1296919852,1296919865,1297005242,13,85377
3830,1296807717,1296814505,1297007185,6788,192680
3863,1297014995,1297015010,1297015010,15,0
3866,1297015136,1297015146,1297015376,10,230
3867,1297015421,1297015431,1297015464,10,33
3869,1297015806,1297016092,1297016116,286,24
3804,1296725288,1296725300,1297021961,12,296661
3871,1297042669,1297042671,1297042736,2,65
3742,1296168460,1296168470,1297043061,10,874591
3872,1297043328,1297043330,1297043366,2,36
3727,1296040047,1296064250,1297064267,24203,1000017
3873,1297058374,1297058376,1297068166,2,9790
3874,1297069072,1297069086,1297069091,14,5
3875,1297070294,1297070300,1297070336,6,36
3878,1297088183,1297088196,1297088199,13,3
3879,1297088239,1297088240,1297088358,1,118
3876,1297088094,1297088105,1297088358,11,253
3883,1297088482,1297088495,1297088496,13,1
3793,1296722101,1296722107,1297093318,6,371211
3885,1297088899,1297088900,1297096832,1,7932
3877,1297088099,1297088105,1297099912,6,11807
3881,1297088373,1297088375,1297101419,2,13044
3882,1297088463,1297088465,1297166944,2,78479
3786,1296634678,1297064285,1297205596,429607,141311
3892,1297220863,1297220870,1297220871,7,1
3891,1297220860,1297220870,1297220871,10,1
3893,1297220866,1297220870,1297220871,4,1
3890,1297220857,1297220870,1297220871,13,1
3894,1297220995,1297221005,1297222072,10,1067
3847,1296864485,1296864500,1297222501,15,358001
3704,1295824093,1295824101,1297237371,8,1413270
3848,1296919698,1297208090,1297268430,288392,60340
3845,1296863903,1296879545,1297273721,15642,394176
3880,1297088326,1297088330,1297281847,4,193517
3703,1295798246,1295878025,1297286464,79779,1408439
3895,1297221442,1297221455,1297286628,13,65173
3896,1297221445,1297221455,1297294073,10,72618
3897,1297221450,1297221455,1297296564,5,75109
3905,1297302310,1297302320,1297304389,10,2069
3903,1297302302,1297302305,1297305054,3,2749
3902,1297302295,1297302305,1297305056,10,2751
3904,1297302307,1297302320,1297305199,13,2879
3906,1297302316,1297302320,1297305239,4,2919
3907,1297302324,1297302335,1297305282,11,2947
3912,1297302338,1297305275,1297307486,2937,2211
3908,1297302327,1297304420,1297307513,2093,3093
3913,1297302341,1297305320,1297307973,2979,2653
3910,1297302333,1297305095,1297308042,2762,2947
3909,1297302330,1297305065,1297308043,2735,2978
3911,1297302336,1297305215,1297308157,2879,2942
3898,1297221453,1297221455,1297309400,2,87945
3914,1297302344,1297307525,1297309735,5181,2210
3915,1297302346,1297307540,1297309753,5194,2213
3916,1297302349,1297308005,1297310213,5656,2208
3917,1297302360,1297308065,1297311193,5705,3128
3918,1297302363,1297308065,1297311189,5702,3124
3919,1297302367,1297308170,1297311300,5803,3130
3900,1297300416,1297300430,1297311541,14,11111
3922,1297302376,1297309775,1297311884,7399,2109
3923,1297302378,1297310240,1297312349,7862,2109
3886,1297220840,1297220856,1297312577,16,91721
3920,1297302369,1297309445,1297312571,7076,3126
3921,1297302372,1297309760,1297312882,7388,3122
3924,1297302382,1297311215,1297313321,8833,2106
3925,1297302385,1297311230,1297313364,8845,2134
3926,1297302388,1297311335,1297313446,8947,2111
3927,1297302390,1297311905,1297314277,9515,2372
3928,1297302393,1297312370,1297314627,9977,2257
3929,1297302397,1297312610,1297314788,10213,2178
3930,1297302400,1297312610,1297314982,10210,2372
3932,1297302415,1297313345,1297315141,10930,1796
3933,1297302417,1297313390,1297315175,10973,1785
3931,1297302412,1297312925,1297315290,10513,2365
3934,1297302420,1297313495,1297315284,11075,1789
3935,1297302426,1297314305,1297316107,11879,1802
3937,1297302431,1297314800,1297316382,12369,1582
3936,1297302428,1297314650,1297316442,12222,1792
3938,1297302435,1297315010,1297316893,12575,1883
3939,1297302438,1297315175,1297317052,12737,1877
3940,1297302441,1297315190,1297317074,12749,1884
3941,1297302445,1297315325,1297317225,12880,1900
3887,1297220845,1297220855,1297320745,10,99890
3888,1297220849,1297220855,1297338233,6,117378
3889,1297220852,1297220855,1297339027,3,118172
3943,1297303960,1297316135,1297348830,12175,32695
3948,1297303995,1297317110,1297348855,13115,31745
3949,1297303998,1297317245,1297348991,13247,31746
3945,1297303985,1297316480,1297348981,12495,32501
3944,1297303962,1297316405,1297348979,12443,32574
3946,1297303989,1297316930,1297348985,12941,32055
3942,1297303955,1297315325,1297348977,11370,33652
3953,1297304012,1297348865,1297349001,44853,136
3947,1297303992,1297317095,1297348988,13103,31893
3954,1297304014,1297348865,1297349002,44851,137
3950,1297304000,1297320770,1297348995,16770,28225
3951,1297304003,1297338245,1297348998,34242,10753
3952,1297304010,1297339040,1297348999,35030,9959
3991,1297349656,1297349660,1297351860,4,2200
3981,1297349626,1297349630,1297352055,4,2425
3982,1297349629,1297349630,1297352372,1,2742
3984,1297349637,1297349645,1297352489,8,2844
3985,1297349640,1297349645,1297352495,5,2850
3986,1297349643,1297349645,1297352546,2,2901
3989,1297349650,1297349660,1297352565,10,2905
3983,1297349632,1297349645,1297352580,13,2935
3987,1297349645,1297349660,1297352568,15,2908
3990,1297349653,1297349660,1297352697,7,3037
3988,1297349648,1297349660,1297352726,12,3066
3993,1297349663,1297352090,1297354048,2427,1958
3992,1297349659,1297351895,1297354544,2236,2649
3994,1297349667,1297352405,1297354600,2738,2195
3995,1297349669,1297352525,1297354721,2856,2196
3996,1297349672,1297352525,1297354851,2853,2326
4002,1297349720,1297352735,1297354871,3015,2136
3998,1297349677,1297352585,1297354906,2908,2321
4000,1297349682,1297352615,1297354987,2933,2372
4001,1297349684,1297352705,1297355054,3021,2349
3999,1297349679,1297352600,1297355074,2921,2474
3997,1297349674,1297352570,1297355675,2896,3105
4003,1297349723,1297354085,1297356218,4362,2133
4011,1297349749,1297355075,1297356849,5326,1774
4004,1297349726,1297354565,1297356886,4839,2321
4005,1297349729,1297354640,1297356961,4911,2321
4012,1297349752,1297355090,1297356959,5338,1869
4006,1297349733,1297354760,1297357105,5027,2345
4007,1297349735,1297354880,1297357122,5145,2242
4008,1297349741,1297354895,1297357270,5154,2375
4009,1297349744,1297354940,1297357284,5196,2344
4010,1297349747,1297355015,1297357364,5268,2349
4013,1297349755,1297355690,1297357482,5935,1792
4014,1297349757,1297356245,1297357755,6488,1510
4015,1297349779,1297356875,1297358646,7096,1771
4016,1297349781,1297356935,1297358822,7154,1887
4017,1297349786,1297357010,1297358884,7224,1874
4019,1297349791,1297357115,1297358983,7324,1868
4018,1297349789,1297357010,1297358976,7221,1966
4020,1297349794,1297357160,1297359047,7366,1887
4027,1297349943,1297358855,1297427948,8912,69093
4026,1297349940,1297358675,1297429260,8735,70585
4025,1297349936,1297357760,1297432780,7824,75020
4021,1297349922,1297357295,1297446716,7373,89421
4029,1297349955,1297359005,1297452628,9050,93623
4030,1297349958,1297359005,1297453381,9047,94376
4022,1297349925,1297357295,1297455809,7370,98514
4031,1297349960,1297359080,1297458325,9120,99245
4023,1297349930,1297357370,1297459280,7440,101910
4024,1297349932,1297357535,1297475390,7603,117855
4033,1297349965,1297429265,1297492702,79300,63437
4034,1297349967,1297432805,1297511065,82838,78260
4035,1297349972,1297446740,1297515836,96768,69096
4061,1297518149,1297518156,1297518157,7,1
4062,1297518151,1297518156,1297518157,5,1
4071,1297520543,1297520555,1297520557,12,2
4072,1297520546,1297520555,1297520557,9,2
4068,1297520433,1297520435,1297525006,2,4571
4063,1297520406,1297520420,1297525899,14,5479
4069,1297520435,1297520450,1297528560,15,8110
4070,1297520438,1297520450,1297528745,12,8295
4066,1297520427,1297520435,1297530888,8,10453
4065,1297520425,1297520435,1297530898,10,10463
4067,1297520430,1297520435,1297530906,5,10471
4074,1297525706,1297525715,1297531441,9,5726
4064,1297520421,1297520435,1297532435,14,12000
3901,1297300510,1297300520,1297535705,10,235185
4073,1297525704,1297525715,1297535750,11,10035
4036,1297349974,1297452650,1297538615,102676,85965
4032,1297349963,1297427975,1297540436,78012,112461
4041,1297349999,1297475420,1297542043,125421,66623
4037,1297349989,1297453400,1297542979,103411,89579
4038,1297349991,1297455830,1297557322,105839,101492
3639,1295393536,1295404010,1297559236,10474,2155226
4039,1297349994,1297458365,1297560017,108371,101652
4042,1297350001,1297492715,1297564451,142714,71736
4040,1297349996,1297459295,1297575440,109299,116145
4043,1297350004,1297511090,1297578637,161086,67547
3420,1293850189,1293850190,1297588394,1,3738204
4077,1297589620,0,0,-1297589620,0
4083,1297589835,1297589840,1297590135,5,295
4080,1297589823,1297589825,1297590118,2,293
4078,1297589817,1297589825,1297590302,8,477
4079,1297589820,1297589825,1297590300,5,475
4081,1297589826,1297589840,1297590318,14,478
4082,1297589832,1297589840,1297590317,8,477
4092,1297591392,1297591400,1297591414,8,14
4096,1297595423,1297595435,1297595436,12,1
4097,1297595425,1297595435,1297595436,10,1
4101,1297595436,1297595450,1297595451,14,1
4100,1297595434,1297595435,1297595436,1,1
4098,1297595429,1297595435,1297595436,6,1
4099,1297595432,1297595435,1297595436,3,1
4102,1297595763,1297595766,1297596094,3,328
4106,1297595773,1297595780,1297596310,7,530
4107,1297595775,1297595780,1297596314,5,534
4103,1297595765,1297595780,1297596413,15,633
4044,1297350007,1297515875,1297598359,165868,82484
4104,1297595767,1297595781,1297600110,14,4329
4105,1297595770,1297595781,1297600101,11,4320
4076,1297589247,1297589255,1297601707,8,12452
4108,1297603503,1297603505,1297611350,2,7845
4113,1297603516,1297603520,1297611407,4,7887
4118,1297603878,1297603880,1297613013,2,9133
4119,1297603880,1297603895,1297613024,15,9129
4049,1297350025,1297557350,1297620998,207325,63648
4110,1297603508,1297603520,1297622313,12,18793
4109,1297603505,1297603520,1297622402,15,18882
4111,1297603510,1297603520,1297623074,10,19554
4112,1297603513,1297603520,1297623080,7,19560
4116,1297603873,1297603880,1297624830,7,20950
4117,1297603875,1297603880,1297625435,5,21555
4114,1297603867,1297603880,1297626471,13,22591
4115,1297603870,1297603880,1297626549,10,22669
4050,1297350031,1297560050,1297629992,210019,69942
4045,1297350016,1297538660,1297631623,188644,92963
4051,1297350034,1297564490,1297634086,214456,69596
4046,1297350018,1297540460,1297638607,190442,98147
4047,1297350020,1297542065,1297641373,192045,99308
4075,1297530429,1297641425,1297641425,110996,0
4048,1297350022,1297543010,1297652423,192988,109413
4052,1297350037,1297575470,1297655538,225433,80068
4053,1297350058,1297578669,1297662397,228611,83728
4057,1297350068,1297630025,1297696480,279957,66455
4055,1297350063,1297598390,1297700027,248327,101637
4059,1297350075,1297634120,1297703121,284045,69001
4058,1297350072,1297631660,1297708098,281588,76438
3800,1296725051,1296725060,1297713813,9,988753
4060,1297350078,1297638620,1297721844,288542,83224
4093,1297592348,1297721855,1297721855,129507,0
4126,1297701084,1297721900,1297721901,20816,1
3702,1295798207,1295872356,1297725542,74149,1853186
4084,1297590160,1297641455,1297728249,51295,86794
4056,1297350066,1297621040,1297740762,270974,119722
4085,1297590163,1297652450,1297755908,62287,103458
4086,1297590165,1297655555,1297757306,65390,101751
4128,1297758188,1297758200,1297758203,12,3
4131,1297758319,1297758320,1297758320,1,0
4132,1297758322,1297758335,1297758335,13,0
4136,1297758382,1297758395,1297758396,13,1
4088,1297590170,1297696505,1297764537,106335,68032
4089,1297590173,1297700075,1297773307,109902,73232
4142,1297774674,1297774685,1297774686,11,1
4087,1297590167,1297662425,1297775157,72258,112732
4054,1297350061,1297588445,1297775400,238384,186955
4090,1297590176,1297703135,1297776709,112959,73574
4095,1297594644,1297775420,1297778349,180776,2929
4143,1297774801,1297774805,1297778384,4,3579
4137,1297759022,1297759025,1297792826,3,33801
4091,1297590179,1297708115,1297800190,117936,92075
4141,1297768111,1297768115,1297800577,4,32462
4127,1297701087,1297721945,1297810884,20858,88939
4130,1297758314,1297758320,1297827111,6,68791
3899,1297300334,1297300340,1297833441,6,533101
4146,1297775504,1297775510,1297859008,6,83498
4147,1297775675,1297775690,1297862571,15,86881
4150,1297775807,1297778420,1297865021,2613,86601
4148,1297775682,1297776740,1297866975,1058,90235
4133,1297758327,1297758335,1297878043,8,119708
4134,1297758330,1297758335,1297881066,5,122731
4145,1297775409,1297775420,1297889258,11,113838
4151,1297775812,1297800230,1297895397,24418,95167
4138,1297759041,1297759055,1297899332,14,140277
4152,1297776229,1297810910,1297913979,34681,103069
4129,1297758250,1297758261,1297930750,11,172489
4155,1297776239,1297862600,1297961128,86361,98528
4154,1297776236,1297859045,1297961945,82809,102900
4157,1297776248,1297867025,1297963224,90777,96199
4156,1297776245,1297865060,1297964148,88815,99088
4158,1297776255,1297889285,1297993925,113030,104640
4159,1297776258,1297895450,1298000214,119192,104764
4144,1297774866,1297774880,1298004923,14,230043
4160,1297776261,1297913990,1298015654,137729,101664
3706,1295922383,1295922396,1298017923,13,2095527
4167,1297778075,1298004965,1298068193,226890,63228
4162,1297778062,1297961960,1298071728,183898,109768
4161,1297776264,1297961165,1298072763,184901,111598
4166,1297778072,1298000255,1298073796,222183,73541
4164,1297778067,1297964195,1298080335,186128,116140
4163,1297778064,1297963265,1298080519,185201,117254
4168,1297778078,1298015675,1298083564,237597,67889
4165,1297778070,1297993970,1298101668,215900,107698
4149,1297775804,1297778390,1298132904,2586,354514
4169,1297778080,1298068205,1298134854,290125,66649
4170,1297778083,1298071760,1298139370,293677,67610
4171,1297778086,1298072810,1298145506,294724,72696
4172,1297778088,1298073815,1298149589,295727,75774
4174,1297778099,1298080550,1298150304,302451,69754
4173,1297778091,1298080355,1298153098,302264,72743
4175,1297778105,1298083595,1298155734,305490,72139
4140,1297767588,1297767590,1298159639,2,392049
4176,1297778118,1298101730,1298171977,323612,70247
4186,1297861364,1298172020,1298172022,310656,2
4185,1297844052,1298159645,1298196109,315593,36464
4195,1298195673,1298196140,1298196140,467,0
4139,1297759082,1297759085,1298196325,3,437240
4178,1297778135,1298134895,1298209161,356760,74266
4204,1298202124,1298202125,1298213163,1,11038
4179,1297778138,1298139410,1298213997,361272,74587
4180,1297778141,1298145530,1298219087,367389,73557
4206,1298202419,1298214005,1298225333,11586,11328
4191,1298195419,1298195420,1298227822,1,32402
4192,1298195431,1298195435,1298228300,4,32865
4193,1298195448,1298195450,1298229473,2,34023
4153,1297776233,1297833470,1298231660,57237,398190
4182,1297778149,1298150345,1298233996,372196,83651
4183,1297778152,1298153120,1298235902,374968,82782
4181,1297778144,1298149610,1298238094,371466,88484
4184,1297778154,1298155760,1298239642,377606,83882
4187,1297861367,1298172050,1298241961,310683,69911
4190,1298195406,1298195420,1298267202,14,71782
4210,1298276966,1298276976,1298276982,10,6
4212,1298284305,1298284310,1298284311,5,1
4211,1298284171,1298284175,1298288596,4,4421
4198,1298196292,1298196351,1298311759,59,115408
4209,1298276737,1298276750,1298320829,13,44079
4194,1298195624,1298195630,1298341336,6,145706
4208,1298275115,1298275130,1298343242,15,68112
4216,1298360168,1298360180,1298360733,12,553
4205,1298202127,1298202140,1298365189,13,163049
4215,1298360007,1298360015,1298366297,8,6282
4217,1298360317,1298360330,1298368219,13,7889
4218,1298360321,1298360330,1298368471,9,8141
4221,1298379809,1298379815,1298380334,6,519
4228,1298380309,1298380310,1298380864,1,554
4226,1298380303,1298380310,1298381063,7,753
4229,1298380312,1298380325,1298381077,13,752
4227,1298380306,1298380310,1298382296,4,1986
4225,1298380301,1298380310,1298382324,9,2014
4230,1298380327,1298380340,1298384669,13,4329
4231,1298380332,1298380895,1298384998,563,4103
4233,1298380337,1298381105,1298385255,768,4150
4232,1298380334,1298381075,1298385559,741,4484
4222,1298379869,1298379875,1298388497,6,8622
4234,1298380340,1298382335,1298393680,1995,11345
4223,1298379891,1298379905,1298396529,14,16624
4214,1298358607,1298358664,1298396549,57,37885
4177,1297778133,1298132930,1298411722,354797,278792
4135,1297758332,1297758335,1298412520,3,654185
4224,1298379914,1298379920,1298428152,6,48232
4207,1298202455,1298213210,1298428338,10755,215128
4242,1298444817,1298444825,1298444826,8,1
4243,1298445009,1298445020,1298445021,11,1
4238,1298443946,1298443955,1298445283,9,1328
4235,1298443936,1298443942,1298445487,6,1545
4239,1298443950,1298443955,1298445546,5,1591
4240,1298443953,1298443955,1298445563,2,1608
4236,1298443939,1298443940,1298445600,1,1660
4237,1298443942,1298443955,1298446511,13,2556
4241,1298443958,1298443970,1298446531,12,2561
4244,1298445055,1298445065,1298446716,10,1651
4246,1298458534,1298458537,1298458540,3,3
4213,1298309168,1298309180,1298470880,12,161700
4259,1298475369,1298475380,1298479351,11,3971
4254,1298475356,1298475365,1298479442,9,4077
4257,1298475364,1298475365,1298481115,1,5750
4260,1298475372,1298479385,1298483498,4013,4113
4256,1298475362,1298475365,1298483839,3,8474
4255,1298475359,1298475365,1298483862,6,8497
4251,1298475197,1298475200,1298485637,3,10437
4258,1298475367,1298475380,1298492702,13,17322
4253,1298475202,1298475215,1298494279,13,19064
4252,1298475200,1298475215,1298506083,15,30868
4249,1298475189,1298475200,1298517807,11,42607
4247,1298475180,1298475247,1298524996,67,49749
4269,1298537538,1298537540,1298537541,2,1
4270,1298537543,1298537555,1298537557,12,2
4271,1298537546,1298537555,1298537557,9,2
4272,1298537550,1298537555,1298537557,5,2
4273,1298537554,1298537555,1298537557,1,2
4265,1298537525,1298537540,1298537541,15,1
4266,1298537528,1298537540,1298537541,12,1
4267,1298537533,1298537540,1298537541,7,1
4268,1298537536,1298537540,1298537541,4,1
4278,1298537569,1298537570,1298537571,1,1
4274,1298537557,1298537570,1298537572,13,2
4275,1298537559,1298537570,1298537572,11,2
4276,1298537562,1298537570,1298537572,8,2
4277,1298537566,1298537570,1298537572,4,2
4281,1298537828,1298537840,1298537904,12,64
4282,1298537832,1298537840,1298537904,8,64
4283,1298537836,1298537840,1298537904,4,64
4284,1298537839,1298537840,1298537904,1,64
4279,1298537819,1298537825,1298537871,6,46
4280,1298537821,1298537825,1298537883,4,58
4285,1298537843,1298537855,1298537938,12,83
4292,1298537978,1298537990,1298538211,12,221
4291,1298537975,1298537990,1298538247,15,257
4286,1298537955,1298537960,1298538237,5,277
4287,1298537958,1298537960,1298538268,2,308
4293,1298538248,1298538260,1298538263,12,3
4294,1298538253,1298538260,1298538263,7,3
4295,1298538270,1298538275,1298538277,5,2
4296,1298538277,1298538290,1298538291,13,1
4297,1298538283,1298538290,1298538291,7,1
4288,1298537961,1298537975,1298538368,14,393
4290,1298537968,1298537975,1298538355,7,380
4298,1298538303,1298538305,1298538306,2,1
4289,1298537965,1298537975,1298538391,10,416
4299,1298538442,1298538455,1298538457,13,2
4300,1298538445,1298538455,1298538458,10,3
4301,1298538447,1298538455,1298538458,8,3
4302,1298538451,1298538455,1298538456,4,1
4303,1298538456,1298538470,1298538471,14,1
4304,1298538459,1298538470,1298538471,11,1
4305,1298538889,1298538890,1298539287,1,397
4307,1298539292,1298539295,1298540013,3,718
4263,1298536460,1298536477,1298542498,17,6021
4248,1298475183,1298475185,1298544347,2,69162
4310,1298554146,1298554162,1298554165,16,3
4250,1298475194,1298475200,1298554655,6,79455
4309,1298541552,1298541561,1298557632,9,16071
4318,1298557653,1298557715,1298570928,62,13213
4264,1298536568,1298536580,1298575541,12,38961
4320,1298557658,1298575565,1298578234,17907,2669
4321,1298557662,1298578250,1298583104,20588,4854
4319,1298557655,1298570975,1298584180,13320,13205
4322,1298557665,1298583125,1298585913,25460,2788
4317,1298554889,1298585930,1298586032,31041,102
4323,1298557668,1298584205,1298588554,26537,4349
4200,1298201864,1298209175,1298590893,7311,381718
4311,1298554687,1298554700,1298605520,13,50820
4312,1298554689,1298554700,1298605576,11,50876
4313,1298554692,1298554700,1298618463,8,63763
4314,1298554697,1298554700,1298622985,3,68285
4329,1298619978,1298619980,1298624873,2,4893
4328,1298619940,1298619950,1298626267,10,6317
4308,1298539536,1298539550,1298627626,14,88076
4330,1298620039,1298620040,1298628106,1,8066
4333,1298631236,1298631245,1298631246,9,1
4336,1298645353,1298645360,1298645613,7,253
4327,1298619422,1298619425,1298649320,3,29895
4335,1298634533,1298634545,1298657387,12,22842
4261,1298536451,1298536460,1298670614,9,134154
4325,1298618823,1298618825,1298674713,2,55888
4326,1298619415,1298619425,1298686913,10,67488
4197,1298196182,1298196185,1298701700,3,505515
4315,1298554700,1298554715,1298707147,15,152432
4316,1298554704,1298557715,1298707176,3011,149461
4337,1298706963,1298706965,1298708838,2,1873
4345,1298709432,1298709440,1298709656,8,216
4346,1298709435,1298709440,1298709656,5,216
4347,1298709438,1298709440,1298709656,2,216
4348,1298709441,1298709455,1298709656,14,201
4349,1298709443,1298709455,1298709656,12,201
4343,1298709408,1298709410,1298709656,2,246
4344,1298709427,1298709440,1298709656,13,216
4352,1298709913,1298709920,1298710169,7,249
4353,1298709917,1298709920,1298710174,3,254
4354,1298709920,1298709935,1298710177,15,242
4355,1298709922,1298709935,1298710180,13,245
4356,1298709925,1298709935,1298710182,10,247
4351,1298709911,1298709920,1298710172,9,252
4350,1298709898,1298709905,1298710217,7,312
4358,1298710479,1298710490,1298710491,11,1
4357,1298710237,1298710250,1298711493,13,1243
4341,1298708092,1298708105,1298730676,13,22571
4364,1298728213,1298728220,1298731440,7,3220
4362,1298714951,1298730695,1298743461,15744,12766
4365,1298747035,1298747083,1298750256,48,3173
4366,1298747039,1298747083,1298760420,44,13337
4367,1298747041,1298750313,1298763496,3272,13183
4262,1298536456,1298670650,1298765294,134194,94644
4372,1298747786,1298765345,1298765346,17559,1
4373,1298747885,1298765345,1298765346,17460,1
4374,1298747888,1298765375,1298765376,17487,1
4375,1298747892,1298765375,1298765376,17483,1
4376,1298747895,1298765420,1298765421,17525,1
4377,1298747908,1298765420,1298765421,17512,1
4378,1298747913,1298765465,1298765466,17552,1
4379,1298748238,1298765465,1298765466,17227,1
4380,1298748244,1298765495,1298765496,17251,1
4381,1298748247,1298765495,1298765496,17248,1
4382,1298748250,1298765540,1298765541,17290,1
4383,1298748253,1298765540,1298765541,17287,1
4384,1298748256,1298765585,1298765586,17329,1
4385,1298748261,1298765585,1298765586,17324,1
4386,1298748567,1298765615,1298765616,17048,1
4387,1298748571,1298765615,1298765616,17044,1
4388,1298748575,1298765660,1298765661,17085,1
4389,1298748578,1298765660,1298765661,17082,1
4390,1298748581,1298765705,1298765706,17124,1
4391,1298748587,1298765705,1298765706,17118,1
4392,1298748591,1298765735,1298765736,17144,1
4363,1298715207,1298743490,1298766655,28283,23165
4189,1298195390,1298195405,1298770493,15,575088
4360,1298711814,1298711825,1298771924,11,60099
4368,1298747045,1298760457,1298773360,13412,12903
4369,1298747048,1298763545,1298776177,16497,12632
4339,1298707159,1298707160,1298776892,1,69732
4370,1298747068,1298765345,1298782606,18277,17261
4371,1298747071,1298765345,1298782603,18274,17258
4340,1298707199,1298707205,1298793379,6,86174
4338,1298707069,1298707070,1298793497,1,86427
4393,1298793290,1298793307,1298794563,17,1256
4395,1298794531,1298794535,1298795086,4,551
4397,1298794536,1298794550,1298795108,14,558
4394,1298794528,1298794535,1298795101,7,566
4396,1298794533,1298794535,1298795100,2,565
4399,1298794540,1298794550,1298795134,10,584
4398,1298794538,1298794550,1298795165,12,615
4400,1298794543,1298794550,1298795150,7,600
4418,1298798154,1298798165,1298798168,11,3
4419,1298798160,1298798165,1298798166,5,1
4417,1298798147,1298798150,1298798174,3,24
4420,1298798229,1298798240,1298798241,11,1
4421,1298798281,1298798285,1298798310,4,25
4413,1298797073,1298797085,1298805526,12,8441
4412,1298797070,1298797085,1298805890,15,8805
4416,1298797080,1298797085,1298806839,5,9754
4410,1298797065,1298797070,1298807391,5,10321
4411,1298797068,1298797070,1298807400,2,10330
4120,1297671616,1297671621,1298809370,5,1137749
4409,1298796261,1298796275,1298813963,14,17688
4331,1298620416,1298623025,1298815991,2609,192966
4414,1298797075,1298797085,1298818740,10,21655
4415,1298797078,1298797085,1298819114,7,22029
4424,1298820370,1298820380,1298820382,10,2
4425,1298820374,1298820380,1298820382,6,2
4426,1298820376,1298820380,1298820382,4,2
4427,1298820378,1298820380,1298820382,2,2
4428,1298820380,1298820396,1298820397,16,1
4429,1298820383,1298820396,1298820397,13,1
4430,1298820387,1298820396,1298820397,9,1
4441,1298821640,1298821655,1298821656,15,1
4423,1298819612,1298819615,1298832595,3,12980
4306,1298539260,1298539265,1298857992,5,318727
4435,1298820465,1298820470,1298859884,5,39414
4436,1298820468,1298820470,1298877236,2,56766
4437,1298820470,1298820485,1298881834,15,61349
4444,1298881028,1298881881,1298881936,853,55
4432,1298820458,1298820470,1298909002,12,88532
4440,1298821170,1298821175,1298915262,5,94087
4434,1298820462,1298820470,1298932525,8,112055
4405,1298795493,1298795495,1298936099,2,140604
4433,1298820460,1298820470,1298936760,10,116290
4431,1298820455,1298820470,1298945087,15,124617
4449,1298966048,1298966060,1298966061,12,1
4448,1298966045,1298966060,1298966060,15,0
4450,1298966051,1298966105,1298966105,54,0
4451,1298966056,1298966105,1298966105,49,0
4453,1298966648,1298966660,1298966660,12,0
4454,1298966652,1298966660,1298966660,8,0
4455,1298966655,1298966705,1298966705,50,0
4456,1298966657,1298966705,1298966705,48,0
4460,1298967837,1298980956,1298980957,13119,1
4442,1298821836,1298858045,1298988867,36209,130822
4401,1298795483,1298795495,1298989484,12,193989
4461,1298967855,1298980956,1298991549,13101,10593
4438,1298820896,1298858045,1298999605,37149,141560
4332,1298620565,1298624915,1299010416,4350,385501
4457,1298966791,1298966795,1299018410,4,51615
4458,1298966823,1298966825,1299027725,2,60900
4324,1298563411,1298588570,1299056828,25159,468258
4404,1298795490,1298795495,1299059897,5,264402
4464,1299050863,1299050870,1299062046,7,11176
4467,1299059728,1299059735,1299062338,7,2603
4466,1299058835,1299058850,1299062489,15,3639
4468,1299060149,1299060155,1299069708,6,9553
4463,1299050850,1299050855,1299071962,5,21107
4470,1299075119,1299075125,1299078496,6,3371
4471,1299075215,1299075230,1299079408,15,4178
4472,1299075301,1299075305,1299086204,4,10899
4469,1299060552,1299060560,1299088816,8,28256
4465,1299050866,1299050870,1299091998,4,41128
4402,1298795485,1298795495,1299111988,10,316493
4447,1298901508,1298915270,1299128488,13762,213218
4219,1298363142,1298363150,1299139336,8,776186
4481,1299145572,1299145580,1299145670,8,90
4482,1299146256,1299146270,1299146271,14,1
4483,1299146294,1299146300,1299146301,6,1
4484,1299146561,1299146570,1299146571,9,1
4485,1299146567,1299146570,1299146570,3,0
4486,1299146683,1299146690,1299146691,7,1
4462,1299050731,1299050736,1299149850,5,99114
4480,1299144344,1299144351,1299159586,7,15235
4477,1299140520,1299140525,1299176638,5,36113
4473,1299138910,1299138920,1299179356,10,40436
4408,1298795559,1298795570,1299191922,11,396352
4495,1299176670,1299179375,1299198283,2705,18908
4220,1298363193,1298363195,1299226269,2,863074
4407,1298795556,1298795570,1299228966,14,433396
4439,1298821167,1298821175,1299231177,8,410002
4497,1299227157,1299231215,1299231216,4058,1
4403,1298795487,1298795495,1299235304,8,439809
4474,1299138969,1299138980,1299242467,11,103487
4493,1299151352,1299226280,1299253660,74928,27380
4499,1299253671,1299253686,1299254430,15,744
4500,1299254440,1299254450,1299254751,10,301
4498,1299227604,1299242495,1299261115,14891,18620
4478,1299143203,1299143212,1299261651,9,118439
4502,1299263357,1299263360,1299263361,3,1
4504,1299264309,1299264320,1299301591,11,37271
4196,1298196029,1298196035,1299349142,6,1153107
4479,1299143212,1299261711,1299349520,118499,87809
4506,1299435848,1299435860,1299464845,12,28985
4406,1298795554,1298795555,1299499190,1,703635
4507,1299497521,1299497525,1299506693,4,9168
4476,1299140296,1299140300,1299534118,4,393818
4501,1299254877,1299254885,1299571750,8,316865
4509,1299572123,1299572137,1299572141,14,4
4508,1299571472,1299571476,1299574191,4,2715
4359,1298711116,1298711120,1299577559,4,866439
4511,1299595516,1299595521,1299600044,5,4523
4514,1299597679,1299597681,1299614408,2,16727
4512,1299596532,1299596540,1299617386,8,20846
4513,1299596674,1299596676,1299629040,2,32364
4510,1299580721,1299580730,1299676415,9,95685
4516,1299684941,1299684951,1299690829,10,5878
4518,1299685181,1299685191,1299692909,10,7718
4515,1299676527,1299676536,1299698719,9,22183
4517,1299685062,1299685070,1299702505,8,17435
4520,1299702410,1299702426,1299713517,16,11091
4519,1299702328,1299702335,1299713596,7,11261
4521,1299702931,1299702936,1299718542,5,15606
4342,1298708192,1298708195,1299721532,3,1013337
4188,1298017956,1298017971,1299741316,15,1723345
4523,1299754771,1299754776,1299765275,5,10499
4522,1299748848,1299748850,1299767979,2,19129
4524,1299756167,1299756171,1299773052,4,16881
4529,1299769639,1299769641,1299778580,2,8939
4528,1299768783,1299768786,1299790138,3,21352
4530,1299775585,1299775596,1299794530,11,18934
4531,1299788393,1299788406,1299797158,13,8752
4503,1299263621,1299263630,1299801312,9,537682
4532,1299798747,1299798755,1299808357,8,9602
4536,1299839727,1299839735,1299839740,8,5
4533,1299831162,1299831170,1299849340,8,18170
4535,1299839572,1299839586,1299851239,14,11653
4534,1299839321,1299839330,1299853247,9,13917
4537,1299840556,1299840561,1299856943,5,16382
4538,1299840700,1299840710,1299867173,10,26463
4541,1299855365,1299857016,1299876474,1651,19458
4543,1299868689,1299876501,1299876505,7812,4
4540,1299855257,1299855261,1299877428,4,22167
4539,1299840867,1299851301,1299879827,10434,28526
4542,1299859232,1299867201,1299885162,7969,17961
4452,1298966398,1298966405,1299918392,7,951987
4547,1299953514,1299953525,1299984140,11,30615
4546,1299952192,1299952206,1299989373,14,37167
4548,1300003341,1300003355,1300004318,14,963
4544,1299916501,1299916505,1300021485,4,104980
4552,1300053196,1300053200,1300054915,4,1715
4553,1300054904,1300054910,1300054917,6,7
4551,1300041025,1300041035,1300062898,10,21863
4549,1300004336,1300004345,1300103564,9,99219
4555,1300104491,1300104500,1300104504,9,4
4556,1300105438,1300105445,1300105450,7,5
4558,1300107453,1300107456,1300107461,3,5
4554,1300092814,1300092816,1300125249,2,32433
4574,1300120221,1300125320,1300136563,5099,11243
4505,1299403058,1299403070,1300149505,12,746435
4562,1300112301,1300136630,1300155174,24329,18544
4559,1300111678,1300111685,1300157582,7,45897
4557,1300107293,1300107306,1300157869,13,50563
4567,1300112951,1300157915,1300157918,44964,3
4569,1300113064,1300157960,1300157964,44896,4
4561,1300112223,1300112225,1300160621,2,48396
4571,1300113173,1300160660,1300160664,47487,4
4572,1300113918,1300160705,1300160709,46787,4
4566,1300112882,1300157615,1300160972,44733,3357
4560,1300112167,1300112180,1300164831,13,52651
4568,1300113019,1300157915,1300169954,44896,12039
4570,1300113122,1300157990,1300172074,44868,14084
4564,1300112435,1300155200,1300180085,42765,24885
4565,1300112503,1300157615,1300185689,45112,28074
4573,1300114033,1300160750,1300185721,46717,24971
4545,1299916516,1299916520,1300195783,4,279263
4589,1300191964,1300191965,1300200078,1,8113
4581,1300176882,1300195820,1300200709,18938,4889
4584,1300181797,1300200740,1300213129,18943,12389
4579,1300176622,1300185755,1300213932,9133,28177
4588,1300182018,1300213955,1300214131,31937,176
4496,1299226261,1299226265,1300217115,4,990850
4563,1300112351,1300136630,1300220895,24279,84265
4587,1300181960,1300213145,1300225268,31185,12123
4575,1300176024,1300176036,1300237565,12,61529
4582,1300181646,1300237610,1300237615,55964,5
4580,1300176690,1300220945,1300237957,44255,17012
4583,1300181722,1300237670,1300246686,55948,9016
4586,1300181898,1300237985,1300249563,56087,11578
4577,1300176434,1300180115,1300258196,3681,78081
4590,1300192000,1300246731,1300264547,54731,17816
4593,1300192524,1300264580,1300264585,72056,5
4578,1300176543,1300185710,1300267007,9167,81297
4594,1300267225,1300267236,1300267291,11,55
4596,1300273639,1300273640,1300273729,1,89
4591,1300192106,1300249610,1300275205,57504,25595
4592,1300192159,1300258250,1300284213,66091,25963
4600,1300291496,1300291506,1300291507,10,1
4601,1300291703,1300291715,1300291716,12,1
4576,1300176228,1300176231,1300297171,3,120940
4603,1300293041,1300293050,1300302346,9,9296
4597,1300273733,1300273760,1300326887,27,53127
4599,1300287275,1300287290,1300327353,15,40063
4598,1300273805,1300275230,1300327522,1425,52292
4595,1300273181,1300273191,1300346140,10,72949
4525,1299758989,1299758990,1300368388,1,609398
4612,1300360413,1300368425,1300369219,8012,794
4605,1300351535,1300351552,1300387651,17,36099
4606,1300352277,1300352286,1300393409,9,41123
4475,1299139283,1299139295,1300397736,12,1258441
4607,1300352689,1300393460,1300402317,40771,8857
4611,1300360048,1300360055,1300404895,7,44840
4610,1300357725,1300387731,1300409384,30006,21653
4617,1300365330,1300409450,1300419303,44120,9853
4608,1300353100,1300393460,1300436380,40360,42920
4620,1300438101,1300438115,1300438116,14,1
4609,1300353260,1300402385,1300443632,49125,41247
4604,1300293149,1300293155,1300455839,6,162684
4615,1300364519,1300397750,1300470233,33231,72483
4621,1300438395,1300438401,1300474243,6,35842
4622,1300438482,1300443710,1300481654,5228,37944
4624,1300439059,1300470275,1300491477,31216,21202
4623,1300439032,1300455860,1300494088,16828,38228
4625,1300439236,1300474295,1300518414,35059,44119
4634,1300448095,1300474295,1300518661,26200,44366
4422,1298799852,1298813990,1300530108,14138,1716118
4629,1300439264,1300494095,1300539650,54831,45555
4627,1300439244,1300481705,1300539996,42461,58291
4631,1300439371,1300518455,1300540180,79084,21725
4636,1300529988,1300539695,1300550383,9707,10688
4632,1300447779,1300518695,1300564430,70916,45735
4633,1300447917,1300518695,1300568780,70778,50085
4635,1300528780,1300564461,1300579213,35681,14752
4626,1300439238,1300481705,1300592166,42467,110461
4630,1300439361,1300474295,1300594504,34934,120209
4619,1300437848,1300437860,1300595573,12,157713
4628,1300439247,1300491515,1300596004,52268,104489
4639,1300603279,1300603280,1300612804,1,9524
4650,1300613319,1300613330,1300613360,11,30
4642,1300612265,1300612280,1300615275,15,2995
4643,1300612268,1300612280,1300615271,12,2991
4644,1300612270,1300612280,1300615240,10,2960
4641,1300612263,1300612265,1300615260,2,2995
4646,1300612275,1300612280,1300615285,5,3005
4647,1300612277,1300612280,1300615290,3,3010
4645,1300612273,1300612280,1300615281,7,3001
4638,1300603177,1300603191,1300619375,14,16184
4652,1300615380,1300615385,1300622206,5,6821
4653,1300615385,1300615400,1300623387,15,7987
4654,1300615388,1300615400,1300623546,12,8146
4651,1300615250,1300615265,1300623959,15,8694
4656,1300615394,1300615400,1300626033,6,10633
4655,1300615391,1300615400,1300626453,9,11053
4662,1300626244,1300626245,1300626510,1,265
4661,1300626079,1300626080,1300627072,1,992
4663,1300627092,1300627100,1300627101,8,1
4664,1300627095,1300627100,1300627101,5,1
4665,1300627098,1300627100,1300627101,2,1
4666,1300627100,1300627115,1300627115,15,0
4669,1300627121,1300627130,1300627130,9,0
4667,1300627103,1300627115,1300627116,12,1
4668,1300627106,1300627115,1300627116,9,1
4658,1300621052,1300621056,1300628414,4,7358
4659,1300622486,1300628480,1300628485,5994,5
4676,1300627339,1300627340,1300629206,1,1866
4671,1300627325,1300627340,1300629652,15,2312
4670,1300627322,1300627325,1300629664,3,2339
4672,1300627329,1300627340,1300629673,11,2333
4673,1300627331,1300627340,1300629665,9,2325
4674,1300627334,1300627340,1300630059,6,2719
4675,1300627337,1300627340,1300630243,3,2903
4614,1300364407,1300369235,1300632566,4828,263331
4657,1300615768,1300615775,1300642815,7,27040
4640,1300603341,1300603355,1300643941,14,40586
4680,1300640203,1300640210,1300646421,7,6211
4679,1300640200,1300640210,1300646777,10,6567
4677,1300640195,1300640210,1300646841,15,6631
4683,1300640210,1300640225,1300647097,15,6872
4678,1300640198,1300640210,1300648070,12,7860
4602,1300291795,1300291805,1300649435,10,357630
4682,1300640208,1300640210,1300649600,2,9390
4684,1300647207,1300647215,1300649820,8,2605
4685,1300650147,1300650155,1300650155,8,0
4687,1300650153,1300650155,1300650156,2,1
4686,1300650151,1300650155,1300650155,4,0
4689,1300650170,1300650185,1300650185,15,0
4688,1300650164,1300650170,1300650171,6,1
4691,1300650175,1300650215,1300650216,40,1
4690,1300650172,1300650185,1300650186,13,1
4660,1300622782,1300628541,1300650382,5759,21841
4681,1300640205,1300640210,1300651491,5,11281
4702,1300654255,1300654265,1300655728,10,1463
4701,1300654253,1300654265,1300655937,12,1672
4705,1300654264,1300655750,1300656708,1486,958
4703,1300654258,1300654265,1300657179,7,2914
4700,1300654250,1300654265,1300657474,15,3209
4706,1300654266,1300655945,1300657555,1679,1610
4704,1300654261,1300654265,1300658258,4,3993
4697,1300651875,1300651880,1300661197,5,9317
4692,1300651853,1300651865,1300664112,12,12247
4696,1300651864,1300651865,1300664646,1,12781
4698,1300651877,1300651880,1300664632,3,12752
4693,1300651856,1300651865,1300665979,9,14114
4694,1300651858,1300651865,1300669269,7,17404
4695,1300651861,1300651865,1300672755,4,20890
4613,1300364356,1300364360,1300679350,4,314990
4550,1300004462,1300004465,1300696163,3,691698
4648,1300612446,1300612820,1300699087,374,86267
4709,1300696013,1300696025,1300699743,12,3718
4707,1300696008,1300696011,1300699800,3,3789
4708,1300696010,1300696025,1300700021,15,3996
4713,1300696025,1300696040,1300700221,15,4181
4710,1300696016,1300696025,1300700496,9,4471
4711,1300696019,1300696025,1300705344,6,9319
4712,1300696021,1300696025,1300706927,4,10902
4722,1300706520,1300706525,1300706928,5,403
4720,1300706514,1300706525,1300706985,11,460
4721,1300706517,1300706525,1300707008,8,483
4723,1300706523,1300706525,1300707011,2,486
4718,1300706509,1300706511,1300707014,2,503
4719,1300706511,1300706525,1300707023,14,498
4724,1300706527,1300706540,1300707658,13,1118
4727,1300707649,1300707650,1300707766,1,116
4729,1300707655,1300707665,1300707762,10,97
4730,1300707657,1300707665,1300707891,8,226
4731,1300707661,1300707665,1300707892,4,227
4725,1300707643,1300707650,1300707888,7,238
4726,1300707646,1300707650,1300707891,4,241
4732,1300707886,1300707890,1300707890,4,0
4733,1300708031,1300708040,1300708041,9,1
4728,1300707652,1300707665,1300708145,13,480
4716,1300696967,1300696970,1300708565,3,11595
4736,1300708919,1300708925,1300709420,6,495
4735,1300708916,1300708925,1300709704,9,779
4739,1300709355,1300709360,1300709753,5,393
4738,1300709352,1300709360,1300709754,8,394
4740,1300709358,1300709360,1300709748,2,388
4737,1300709349,1300709360,1300710267,11,907
4741,1300709360,1300709375,1300710281,15,906
4715,1300696965,1300696970,1300710997,5,14027
4616,1300364903,1300404920,1300711013,40017,306093
4747,1300711036,1300711040,1300711169,4,129
4743,1300710310,1300710320,1300711360,10,1040
4714,1300696961,1300696970,1300711368,9,14398
4749,1300711188,1300711190,1300711435,2,245
4751,1300711429,1300711430,1300711915,1,485
4717,1300696970,1300696985,1300711956,15,14971
4754,1300711525,1300711535,1300712027,10,492
4752,1300711442,1300711445,1300712559,3,1114
4753,1300711523,1300711535,1300712638,12,1103
4742,1300709493,1300709495,1300719291,2,9796
4762,1300717406,1300717415,1300719385,9,1970
4750,1300711374,1300711385,1300725578,11,14193
4734,1300708875,1300708880,1300737352,5,28472
4637,1300530153,1300540040,1300737608,9887,197568
4744,1300710938,1300710951,1300740647,13,29696
4756,1300711892,1300712075,1300743419,183,31344
4748,1300711151,1300711160,1300743822,9,32662
4760,1300715982,1300743455,1300745714,27473,2259
4761,1300716112,1300743860,1300751148,27748,7288
4649,1300612554,1300615325,1300756955,2771,141630
4757,1300713768,1300737650,1300757262,23882,19612
4755,1300711741,1300712660,1300757535,919,44875
4759,1300715888,1300740695,1300764341,24807,23646
4526,1299759514,1299759515,1300777119,1,1017604
4758,1300714549,1300740695,1300777542,26146,36847
4527,1299759616,1299759620,1300778323,4,1018703
4765,1300777773,1300777775,1300778368,2,593
4764,1300777363,1300777370,1300779269,7,1899
4770,1300778227,1300778240,1300779269,13,1029
4772,1300779521,1300779530,1300779825,9,295
4773,1300779527,1300779530,1300779835,3,305
4699,1300653628,1300653635,1300779864,7,126229
4777,1300780033,1300780040,1300780041,7,1
4776,1300779956,1300779965,1300780272,9,307
4775,1300779805,1300779815,1300780683,10,868
4768,1300777949,1300777955,1300784002,6,6047
4767,1300777921,1300777925,1300784101,4,6176
4766,1300777888,1300777895,1300786869,7,8974
4782,1300787167,1300787180,1300787185,13,5
4785,1300787617,1300787630,1300790830,13,3200
4774,1300779802,1300779815,1300796056,13,16241
4786,1300787764,1300790870,1300799435,3106,8565
4780,1300787031,1300787045,1300800834,14,13789
4784,1300787499,1300800890,1300800894,13391,4
4789,1300791216,1300800935,1300800940,9719,5
4783,1300787295,1300787300,1300801912,5,14612
4778,1300786736,1300786746,1300802206,10,15460
4793,1300804784,1300804790,1300805266,6,476
4790,1300792165,1300800965,1300807414,8800,6449
4792,1300804192,1300804205,1300808173,13,3968
4787,1300788130,1300796075,1300810038,7945,13963
4788,1300788194,1300799480,1300812569,11286,13089
4779,1300786903,1300786911,1300815150,8,28239
4796,1300808391,1300808405,1300819058,14,10653
4797,1300816992,1300817001,1300825242,9,8241
4798,1300817095,1300817106,1300825526,11,8420
4791,1300804189,1300804190,1300825668,1,21478
4795,1300808040,1300808045,1300833733,5,25688
4745,1300710967,1300710980,1300853675,13,142695
4794,1300807450,1300807460,1300854163,10,46703
4802,1300867552,1300867565,1300867567,13,2
4805,1300875110,1300875125,1300875842,15,717
4808,1300878115,1300878125,1300878306,10,181
4809,1300885910,1300885925,1300886486,15,561
4810,1300886386,1300886390,1300886774,4,384
4489,1299150504,1299150515,1300887114,11,1736599
4807,1300876989,1300877000,1300890650,11,13650
4769,1300778047,1300778060,1300893949,13,115889
4812,1300894147,1300894160,1300894161,13,1
4813,1300894203,1300894205,1300894206,2,1
4806,1300876954,1300876955,1300894268,1,17313
4815,1300894291,1300894295,1300894296,4,1
4817,1300894692,1300894700,1300895289,8,589
4819,1300894889,1300894895,1300896116,6,1221
4820,1300896184,1300896185,1300896185,1,0
4822,1300896252,1300896260,1300896261,8,1
4823,1300896400,1300896410,1300896410,10,0
4824,1300896708,1300896710,1300898431,2,1721
4804,1300872252,1300872261,1300905800,9,33539
4618,1300437819,1300437830,1300915339,11,477509
4800,1300863135,1300863141,1300921249,6,58108
4818,1300894719,1300894730,1300925914,11,31184
4201,1298201897,1298231705,1300937368,29808,2705663
4825,1300910206,1300910211,1300938984,5,28773
4799,1300818040,1300819100,1300955920,1060,136820
4829,1300959375,1300959380,1300959380,5,0
4826,1300955952,1300955962,1300966959,10,10997
4831,1300965618,1300967017,1300967033,1399,16
4746,1300711020,1300711025,1300973440,5,262415
4835,1300968138,1300973480,1300973485,5342,5
4763,1300777131,1300777146,1301000262,15,223116
4821,1300896220,1300896230,1301003154,10,106924
4828,1300959066,1300959080,1301004006,14,44926
4837,1300988615,1301004035,1301008034,15420,3999
4838,1300989185,1301008085,1301014229,18900,6144
4836,1300987222,1300987237,1301015610,15,28373
4801,1300867324,1300867325,1301025609,1,158284
4811,1300893958,1300893965,1301033717,7,139752
4832,1300967906,1300967915,1301038683,9,70768
4833,1300967972,1300967975,1301047342,3,79367
4839,1301040584,1301040591,1301050097,7,9506
4840,1301040663,1301040666,1301050158,3,9492
4803,1300868007,1300868015,1301057045,8,189030
4816,1300894631,1300894640,1301094940,9,200300
4834,1300968025,1300968035,1301098405,10,130370
4848,1301135519,1301135525,1301135680,6,155
4849,1301135522,1301135525,1301135672,3,147
4847,1301135468,1301135480,1301135687,12,207
4850,1301135525,1301135540,1301135821,15,281
4851,1301135528,1301135540,1301135809,12,269
4852,1301135530,1301135540,1301135806,10,266
4846,1301135409,1301135420,1301135975,11,555
4859,1301136106,1301136110,1301137124,4,1014
4862,1301136115,1301136125,1301138106,10,1981
4863,1301136117,1301137175,1301138191,1058,1016
4861,1301136112,1301136125,1301138307,13,2182
4860,1301136109,1301136110,1301138444,1,2334
4865,1301136123,1301138210,1301139224,2087,1014
4866,1301136646,1301138330,1301139758,1684,1428
4867,1301136649,1301138465,1301139977,1816,1512
4868,1301136652,1301139245,1301140031,2593,786
4864,1301136120,1301138120,1301140452,2000,2332
4871,1301136660,1301140055,1301140850,3395,795
4869,1301136655,1301139770,1301141271,3115,1501
4870,1301136657,1301140025,1301141509,3368,1484
4872,1301136663,1301140490,1301142082,3827,1592
4858,1301135563,1301135570,1301142712,7,7142
4882,1301143646,1301143655,1301143655,9,0
4876,1301143614,1301143625,1301143627,11,2
4877,1301143617,1301143625,1301143627,8,2
4878,1301143619,1301143625,1301143627,6,2
4879,1301143623,1301143625,1301143627,2,2
4880,1301143626,1301143640,1301143641,14,1
4881,1301143634,1301143640,1301143641,6,1
4857,1301135556,1301135570,1301146360,14,10790
4873,1301136667,1301136680,1301148342,13,11662
4874,1301136849,1301140895,1301149059,4046,8164
4853,1301135541,1301135555,1301151992,14,16437
4893,1301145248,1301146385,1301166421,1137,20036
4894,1301145250,1301148380,1301166678,3130,18298
4841,1301049150,1301049155,1301167230,5,118075
4896,1301145257,1301149085,1301167256,3828,18171
4897,1301145259,1301149085,1301171387,3826,22302
4898,1301145262,1301149085,1301173111,3823,24026
4854,1301135544,1301135555,1301174982,11,39427
4843,1301057319,1301057330,1301174996,11,117666
4883,1301143786,1301143790,1301175747,4,31957
4895,1301145254,1301149085,1301180619,3831,31534
4900,1301145268,1301166455,1301184460,21187,18005
4907,1301145292,1301167280,1301184767,21988,17487
4856,1301135550,1301135555,1301186050,5,50495
4902,1301145274,1301167280,1301187633,22006,20353
4904,1301145279,1301167280,1301187990,22001,20710
4910,1301145301,1301167295,1301189864,21994,22569
4906,1301145289,1301167280,1301190289,21991,23009
4909,1301145297,1301167280,1301190343,21983,23063
4901,1301145271,1301166695,1301191148,21424,24453
4905,1301145282,1301167280,1301191155,21998,23875
4884,1301143788,1301143790,1301191720,2,47930
4903,1301145276,1301167280,1301191768,22004,24488
4908,1301145294,1301167280,1301192041,21986,24761
4911,1301145304,1301171405,1301192362,26101,20957
4933,1301145385,1301192375,1301192375,46990,0
4914,1301145311,1301175020,1301192396,29709,17376
4855,1301135547,1301135555,1301194680,8,59125
4912,1301145306,1301173130,1301195051,27824,21921
4891,1301145242,1301145245,1301196348,3,51103
4915,1301145314,1301175020,1301196560,29706,21540
4917,1301145319,1301175020,1301197017,29701,21997
4916,1301145317,1301175020,1301198309,29703,23289
4899,1301145265,1301152010,1301198417,6745,46407
4935,1301145390,1301192420,1301205797,47030,13377
4920,1301145347,1301184500,1301206282,39153,21782
4890,1301145240,1301145245,1301206320,5,61075
4921,1301145349,1301184800,1301206383,39451,21583
4928,1301145372,1301191190,1301206532,45818,15342
4919,1301145345,1301180660,1301207088,35315,26428
4918,1301145322,1301175785,1301207362,30463,31577
4927,1301145369,1301190365,1301208806,44996,18441
4892,1301145245,1301145260,1301210447,15,65187
4930,1301145377,1301191745,1301210868,46368,19123
4934,1301145388,1301192420,1301211216,47032,18796
4926,1301145366,1301190320,1301211602,44954,21282
4925,1301145363,1301189900,1301211632,44537,21732
4932,1301145383,1301192075,1301212327,46692,20252
4937,1301145396,1301195090,1301212405,49694,17315
4939,1301212672,1301212685,1301212687,13,2
4940,1301212675,1301212685,1301212687,10,2
4941,1301212677,1301212685,1301212687,8,2
4942,1301212680,1301212685,1301212687,5,2
4943,1301212682,1301212685,1301212686,3,1
4944,1301212685,1301212700,1301212700,15,0
4945,1301212689,1301212700,1301212700,11,0
4929,1301145374,1301191205,1301212854,45831,21649
4888,1301143799,1301143805,1301214290,6,70485
4931,1301145380,1301191805,1301215145,46425,23340
4886,1301143794,1301143805,1301215386,11,71581
4924,1301145359,1301188010,1301216061,42651,28051
4885,1301143791,1301143805,1301218277,14,74472
4957,1301213006,1301213015,1301218290,9,5275
4955,1301213001,1301213015,1301218312,14,5297
4956,1301213004,1301213015,1301218331,11,5316
4953,1301212996,1301213000,1301218529,4,5529
4954,1301212998,1301213000,1301218539,2,5539
4923,1301145354,1301187650,1301219226,42296,31576
4958,1301213011,1301215160,1301220226,2149,5066
4913,1301145309,1301175005,1301220437,29696,45432
4960,1301213022,1301218325,1301224215,5303,5890
4963,1301213030,1301218550,1301224264,5520,5714
4962,1301213027,1301218370,1301224558,5343,6188
4964,1301213032,1301218580,1301224610,5548,6030
4961,1301213025,1301218340,1301224659,5315,6319
4959,1301213016,1301215430,1301225539,2414,10109
4966,1301213038,1301220245,1301226402,7207,6157
4949,1301212981,1301212985,1301226548,4,13563
4948,1301212979,1301212985,1301227264,6,14279
4951,1301212987,1301213000,1301227310,13,14310
4947,1301212977,1301212985,1301227359,8,14374
4952,1301212990,1301213000,1301227388,10,14388
4946,1301212974,1301212985,1301227405,11,14420
4965,1301213035,1301219240,1301228526,6205,9286
4969,1301213065,1301224310,1301228787,11245,4477
4970,1301213068,1301224580,1301228951,11512,4371
4968,1301213062,1301224235,1301229180,11173,4945
4971,1301213071,1301224625,1301229379,11554,4754
4972,1301213073,1301224700,1301229507,11627,4807
4974,1301213081,1301226440,1301230972,13359,4532
4889,1301143801,1301143805,1301231481,4,87676
4975,1301213083,1301227295,1301231675,14212,4380
4977,1301213089,1301227415,1301231894,14326,4479
4978,1301213092,1301228570,1301232910,15478,4340
4980,1301213098,1301228975,1301233269,15877,4294
4967,1301213060,1301220455,1301233730,7395,13275
4976,1301213086,1301227400,1301233797,14314,6397
4981,1301213542,1301229200,1301234272,15658,5072
4983,1301213547,1301229545,1301234427,15998,4882
4973,1301213077,1301225585,1301234569,12508,8984
4982,1301213544,1301229425,1301234619,15881,5194
4984,1301213549,1301231000,1301235454,17451,4454
4979,1301213095,1301228825,1301236070,15730,7245
4986,1301213554,1301231705,1301236886,18151,5181
4987,1301213557,1301231945,1301237137,18388,5192
4997,1301237579,1301237585,1301237586,6,1
4998,1301237610,1301237615,1301237621,5,6
4999,1301237661,1301237675,1301237676,14,1
5000,1301237671,1301237675,1301237677,4,2
4922,1301145352,1301186090,1301240348,40738,54258
4996,1301213871,1301234465,1301242551,20594,8086
4950,1301212984,1301212985,1301243402,1,30417
4985,1301213552,1301231495,1301245242,17943,13747
4936,1301145393,1301194685,1301245373,49292,50688
4938,1301145399,1301196365,1301245525,50966,49160
4887,1301143796,1301143805,1301249784,9,105979
5003,1301240251,1301240255,1301251347,4,11092
5002,1301240247,1301240255,1301251501,8,11246
5004,1301240255,1301240270,1301252091,15,11821
5008,1301240268,1301240270,1301253791,2,13521
5006,1301240260,1301240270,1301255357,10,15087
5007,1301240263,1301240270,1301255589,7,15319
5005,1301240257,1301240270,1301266775,13,26505
4845,1301132589,1301132602,1301282878,13,150276
5009,1301305571,1301305580,1301312195,9,6615
4988,1301213703,1301234315,1301371508,20612,137193
5010,1301383874,1301383880,1301383880,6,0
5016,1301412816,1301412830,1301412835,14,5
5018,1301412889,1301412890,1301412893,1,3
5019,1301413098,1301413100,1301413105,2,5
5020,1301413102,1301413115,1301413118,13,3
5021,1301413904,1301413910,1301413913,6,3
5013,1301384230,1301384240,1301416900,10,32660
5022,1301469426,1301469440,1301469446,14,6
5024,1301470496,1301470505,1301470509,9,4
5023,1301470485,1301470490,1301470498,5,8
5025,1301472977,1301472980,1301472991,3,11
5026,1301475930,1301475935,1301475956,5,21
5027,1301477282,1301477285,1301477351,3,66
5028,1301494935,1301494940,1301494941,5,1
5011,1301384106,1301384120,1301498441,14,114321
5029,1301568797,1301568800,1301568928,3,128
5030,1301568874,1301568875,1301569107,1,232
5033,1301571140,1301571155,1301571489,15,334
5031,1301569771,1301569775,1301571872,4,2097
5034,1301571181,1301571185,1301572050,4,865
5035,1301572268,1301572281,1301572286,13,5
5032,1301569856,1301569865,1301572810,9,2945
5036,1301573103,1301573106,1301573110,3,4
5037,1301573186,1301573196,1301573695,10,499
5038,1301573747,1301573751,1301573779,4,28
5040,1301573949,1301573960,1301574081,11,121
5041,1301574118,1301574125,1301575176,7,1051
5042,1301574122,1301574125,1301575552,3,1427
5039,1301573824,1301573825,1301576179,1,2354
5044,1301576326,1301576330,1301576756,4,426
5043,1301576247,1301576255,1301577035,8,780
5045,1301580560,1301580575,1301580580,15,5
5046,1301580642,1301580650,1301580655,8,5
5047,1301580844,1301580845,1301580849,1,4
5048,1301580970,1301580980,1301580985,10,5
5049,1301581005,1301581010,1301581014,5,4
5051,1301581579,1301581580,1301581584,1,4
5050,1301581362,1301581370,1301582451,8,1081
5052,1301586282,1301586290,1301586290,8,0
5054,1301586292,1301586305,1301586305,13,0
5055,1301586858,1301586860,1301586860,2,0
5056,1301586890,1301586905,1301586905,15,0
5059,1301587060,1301587070,1301587070,10,0
5061,1301587517,1301587520,1301587521,3,1
5062,1301587592,1301587595,1301587596,3,1
5057,1301586985,1301586995,1301593700,10,6705
5065,1301594323,1301594330,1301597556,7,3226
5012,1301384113,1301384120,1301662034,7,277914
5067,1301667872,1301667875,1301667991,3,116
5068,1301667995,1301668010,1301668516,15,506
4844,1301057488,1301057495,1301674836,7,617341
5070,1301745944,1301745950,1301745950,6,0
4245,1298455239,1298455251,1301770135,12,3314884
4830,1300959455,1300959470,1301858099,15,898629
5066,1301650717,1301650730,1301861620,13,210890
4771,1300779152,1300779155,1301876515,3,1097360
4491,1299150855,1299159635,1301888328,8780,2728693
5075,1301923135,1301923145,1301923150,10,5
5076,1301923304,1301923310,1301923351,6,41
5079,1301923539,1301923550,1301923553,11,3
5073,1301922869,1301922875,1301924617,6,1742
5071,1301922708,1301922710,1301924873,2,2163
5074,1301922978,1301922980,1301925163,2,2183
5072,1301922787,1301922800,1301925251,13,2451
5078,1301923449,1301923461,1301927602,12,4141
5088,1301926998,1301927630,1301927634,632,4
5087,1301926922,1301926925,1301930405,3,3480
5089,1301927090,1301927675,1301930735,585,3060
5090,1301927188,1301930420,1301933129,3232,2709
5077,1301923373,1301923385,1301935346,12,11961
5091,1301927480,1301930750,1301935641,3270,4891
5086,1301924568,1301925200,1301937865,632,12665
5085,1301924553,1301924915,1301937997,362,13082
5093,1301927767,1301935385,1301938892,7618,3507
5092,1301927569,1301933180,1301941691,5611,8511
5095,1301929303,1301938040,1301942049,8737,4009
5084,1301924513,1301924645,1301948483,132,23838
5082,1301924406,1301924420,1301990055,14,65635
5098,1301993408,1301993421,1302002519,13,9098
5083,1301924509,1301924510,1302005963,1,81453
5096,1301992706,1301992715,1302007289,9,14574
5101,1302007866,1302007881,1302007885,15,4
5097,1301993316,1301993330,1302010211,14,16881
5103,1302008990,1302009005,1302012297,15,3292
5100,1302006510,1302006515,1302014486,5,7971
5099,1302006354,1302006365,1302014747,11,8382
5102,1302008531,1302008541,1302015240,10,6699
5094,1301929196,1301935685,1302015988,6489,80303
5104,1302009988,1302012336,1302017837,2348,5501
5015,1301384562,1301384570,1302019448,8,634878
5108,1302022317,1302022326,1302022330,9,4
5109,1302022332,1302022416,1302022421,84,5
5110,1302022344,1302022475,1302022479,131,4
5111,1302022355,1302022535,1302022539,180,4
5105,1302012669,1302014525,1302022622,1856,8097
5112,1302022759,1302022760,1302022764,1,4
5113,1302022769,1302022775,1302022779,6,4
5114,1302022777,1302022835,1302022839,58,4
5106,1302021528,1302021531,1302029619,3,8088
5107,1302021628,1302021636,1302031169,8,9533
5118,1302023036,1302031235,1302031241,8199,6
5115,1302022999,1302023000,1302031671,1,8671
5116,1302023012,1302023015,1302031647,3,8632
5121,1302023071,1302031730,1302032913,8659,1183
5120,1302023061,1302031700,1302033488,8639,1788
5119,1302023049,1302031310,1302034167,8261,2857
5124,1302035342,1302035346,1302040585,4,5239
5117,1302023026,1302029690,1302042918,6664,13228
5080,1301923883,1301923895,1302045135,12,121240
5125,1302035459,1302040625,1302045793,5166,5168
5126,1302035565,1302042951,1302046930,7386,3979
5123,1302035205,1302035211,1302063033,6,27822
5122,1302035109,1302035121,1302064342,12,29221
5131,1302078840,1302078846,1302102368,6,23522
5132,1302115958,1302115971,1302119911,13,3940
5133,1302116030,1302116046,1302121361,16,5315
5128,1302071199,1302071210,1302124930,11,53720
5135,1302121613,1302121626,1302125235,13,3609
5134,1302120314,1302120321,1302134447,7,14126
5136,1302157391,1302157402,1302157408,11,6
5137,1302157772,1302157776,1302157780,4,4
5138,1302157897,1302157910,1302157914,13,4
5140,1302157944,1302158000,1302158004,56,4
5139,1302157935,1302157941,1302157946,6,5
5141,1302158561,1302158572,1302164141,11,5569
5142,1302158576,1302158585,1302164992,9,6407
5144,1302164718,1302164720,1302170356,2,5636
5143,1302158583,1302164210,1302171072,5627,6862
5145,1302166831,1302166836,1302181601,5,14765
5148,1302183064,1302183065,1302183069,1,4
5149,1302183121,1302183125,1302183129,4,4
5146,1302173931,1302173946,1302185804,15,11858
5150,1302183230,1302183245,1302187193,15,3948
5147,1302174058,1302174065,1302187357,7,13292
5151,1302183292,1302183305,1302188476,13,5171
5154,1302188621,1302188630,1302193497,9,4867
5156,1302194413,1302194420,1302194547,7,127
5152,1302188369,1302188376,1302194539,7,6163
5153,1302188575,1302188586,1302194728,11,6142
5157,1302194578,1302194585,1302198549,7,3964
5155,1302193639,1302193641,1302201124,2,7483
5158,1302195127,1302195140,1302209904,13,14764
5159,1302241886,1302241896,1302241898,10,2
5160,1302241949,1302241955,1302241956,6,1
5161,1302242126,1302242135,1302242136,9,1
5165,1302247732,1302247746,1302252409,14,4663
5164,1302247425,1302247431,1302260317,6,12886
5168,1302267217,1302267231,1302267238,14,7
5166,1302260772,1302260780,1302278905,8,18125
5060,1301587121,1301587130,1302325643,9,738513
5169,1302332343,1302332346,1302338662,3,6316
5069,1301745878,1301745890,1302350605,12,604715
5167,1302262139,1302262146,1302352967,7,90821
5170,1302332602,1302332616,1302354057,14,21441
5171,1302332756,1302338721,1302376241,5965,37520
5172,1302416639,1302416645,1302416647,6,2
5173,1302416895,1302416900,1302416900,5,0
5177,1302417671,1302417680,1302417680,9,0
5127,1302071152,1302071165,1302444822,13,373657
5176,1302417668,1302417680,1302468185,12,50505
5183,1302417717,1302468230,1302468230,50513,0
5180,1302417704,1302417710,1302585849,6,168139
5081,1301924174,1301924180,1302600602,6,676422
5182,1302417714,1302444845,1302600660,27131,155815
5179,1302417698,1302417710,1302600881,12,183171
4814,1300894280,1300894295,1302601588,15,1707293
5192,1302417774,1302600920,1302601888,183146,968
5188,1302417750,1302600620,1302601888,182870,1268
5190,1302417762,1302600695,1302601948,182933,1253
5058,1301587053,1301587055,1302602145,2,1015090
5199,1302515012,1302601640,1302606815,86628,5175
5203,1302601105,1302601970,1302609077,865,7107
5206,1302602200,1302609095,1302609095,6895,0
5205,1302602093,1302606830,1302646709,4737,39879
5053,1301586289,1301586290,1302779113,1,1192823
5064,1301588418,1301588420,1302779148,2,1190728
5207,1302602408,1302779195,1302785673,176787,6478
5211,1302609441,1302779120,1302788500,169679,9380
5184,1302417721,1302468275,1302853763,50554,385488
5216,1302620419,1302788526,1302855432,168107,66906
4842,1301057104,1301057106,1302862506,2,1805400
5174,1302416966,1302416975,1302862542,9,445567
5163,1302242326,1302242330,1302862830,4,620500
5178,1302417675,1302417680,1302865797,5,448117
5213,1302618794,1302865835,1302938270,247041,72435
5212,1302618789,1302862580,1302945036,243791,82456
5214,1302618802,1302938285,1302956637,319483,18352
5210,1302605449,1302862550,1302988148,257101,125598
5215,1302618854,1302945065,1303026901,326211,81836
5208,1302602944,1302609140,1303077720,6196,468580
5219,1303026911,1303026920,1303161732,9,134812
5220,1303026914,1303026920,1303204269,6,177349
5218,1302854899,1302854900,1303224161,1,369261
5181,1302417709,1302417755,1303253099,46,835344
5222,1303213202,1303213209,1303333787,7,120578
3748,1296298345,1296298357,1303373504,12,7075147
5229,1303373957,1303373960,1303380441,3,6481
5223,1303371993,1303371997,1303380951,4,8954
5224,1303373472,1303373480,1303382628,8,9148
5227,1303373950,1303373960,1303389118,10,15158
5228,1303373954,1303373960,1303389131,6,15171
5129,1302071790,1302071795,1303477621,5,1405826
5225,1303373945,1303373964,1303522537,19,148573
5226,1303373948,1303373964,1303522748,16,148784
5230,1303374317,1303380982,1303631731,6665,250749
5162,1302242323,1302242330,1303667889,7,1425559
5221,1303027099,1303077770,1303673178,50671,595408
4827,1300958939,1300958946,1303756218,7,2797272
4487,1299148001,1299149885,1303809659,1884,4659774
5186,1302417738,1302585890,1303809778,168152,1223888
5244,1303823536,1303823541,1303823562,5,21
5245,1303823698,1303823708,1303823755,10,47
5246,1303823745,1303823751,1303823784,6,33
5247,1303823817,1303823855,1303823888,38,33
5249,1303824698,1303824710,1303824740,12,30
5248,1303824682,1303824695,1303824726,13,31
5250,1303824706,1303824845,1303824876,139,31
5243,1303823073,1303823076,1303828123,3,5047
5251,1303831510,1303831521,1303831552,11,31
5252,1303831620,1303831626,1303831655,6,29
5232,1303810537,1303810550,1303841714,13,31164
5241,1303814893,1303814900,1303861853,7,46953
5238,1303814883,1303814885,1303928925,2,114040
5253,1303904283,1303904287,1303930307,4,26020
5255,1303906313,1303930370,1303930400,24057,30
5233,1303810697,1303810702,1303930279,5,119577
5256,1303906403,1303916540,1303947157,10137,30617
5257,1303906463,1303916720,1303953470,10257,36750
5234,1303810727,1303810730,1303955244,3,144514
5254,1303905008,1303905022,1303968302,14,63280
5014,1301384556,1301384570,1303982699,14,2598129
5239,1303814887,1303841765,1303982993,26878,141228
5237,1303814881,1303814886,1303982963,5,168077
5240,1303814890,1303916690,1303983015,101800,66325
5242,1303814895,1303931691,1303983062,116796,51371
5259,1303980773,1303983127,1303983127,2354,0
5270,1303998118,1303998125,1303998126,7,1
5261,1303982557,1303982570,1304063200,13,80630
5202,1302600619,1302601940,1304064631,1321,1462691
5276,1304069026,1304069030,1304069065,4,35
5277,1304069255,1304069270,1304069286,15,16
5268,1303983406,1303983410,1304087428,4,104018
5280,1304090334,1304090345,1304090383,11,38
5278,1304086869,1304086880,1304090568,11,3688
5281,1304090553,1304090556,1304090609,3,53
5279,1304088477,1304088485,1304092515,8,4030
5282,1304091297,1304091305,1304092882,8,1577
5264,1303983394,1303983395,1304095299,1,111904
5287,1304154444,1304154455,1304154456,11,1
5285,1304148785,1304148800,1304155212,15,6412
5284,1304148589,1304148590,1304155457,1,6867
5291,1304155995,1304156000,1304156005,5,5
5292,1304156200,1304156210,1304156214,10,4
5293,1304156306,1304156315,1304156320,9,5
5294,1304156388,1304156390,1304156406,2,16
5286,1304148838,1304148845,1304159161,7,10316
5295,1304164488,1304164490,1304164495,2,5
5296,1304165136,1304165150,1304165155,14,5
5235,1303810782,1303810799,1304165947,17,355148
4199,1298196439,1298196441,1304171980,2,5975539
5231,1303807782,1303807790,1304188600,8,380810
5267,1303983403,1304095325,1304227627,111922,132302
5262,1303982773,1303983005,1304250266,232,267261
5288,1304155265,1304155280,1304256461,15,101181
5289,1304155271,1304155280,1304256452,9,101172
5297,1304166217,1304166230,1304263058,13,96828
5283,1304148341,1304251145,1304292445,102804,41300
5263,1303982818,1303982825,1304326669,7,343844
5302,1304331179,1304331185,1304348041,6,16856
5299,1304256488,1304256500,1304348142,12,91642
5130,1302071906,1302071915,1304348187,9,2276272
5209,1302602962,1302646715,1304348452,43753,1701737
5175,1302416994,1302417005,1304348485,11,1931480
5301,1304331169,1304331170,1304349965,1,18795
5303,1304331727,1304331740,1304356529,13,24789
5063,1301587624,1301587625,1304363864,1,2776239
5309,1304358042,1304358050,1304375457,8,17407
5271,1304018882,1304018885,1304408243,3,389358
5275,1304065221,1304065235,1304410016,14,344781
5204,1302601983,1302602150,1304410133,167,1807983
5313,1304415592,1304415605,1304415608,13,3
5314,1304418768,1304418770,1304418774,2,4
5317,1304419237,1304419251,1304419256,14,5
5265,1303983397,1303983410,1304420185,13,436775
5315,1304418885,1304418890,1304433141,5,14251
5316,1304418913,1304418920,1304459875,7,40955
5322,1304439759,1304439771,1304466339,12,26568
5321,1304419878,1304419881,1304466484,3,46603
5312,1304415540,1304415547,1304472744,7,57197
5304,1304347579,1304347580,1304481311,1,133731
5326,1304511250,1304511250,1304511890,0,640
5307,1304347917,1304348240,1304513908,323,165668
5325,1304500877,1304500880,1304529199,3,28319
5310,1304358058,1304358065,1304531141,7,173076
5324,1304493320,1304493336,1304535545,16,42209
5320,1304419771,1304419775,1304542229,4,122454
5306,1304347905,1304348180,1304562220,275,214040
5311,1304414702,1304414705,1304583821,3,169116
5328,1304595273,1304595280,1304595281,7,1
5335,1304599884,1304599885,1304599886,1,1
5337,1304604729,1304604730,1304604732,1,2
5338,1304604869,1304604880,1304604884,11,4
5339,1304605059,1304605060,1304605064,1,4
5340,1304605059,1304605060,1304605064,1,4
5341,1304605059,1304605060,1304605064,1,4
5342,1304605059,1304605060,1304605064,1,4
5343,1304605059,1304605060,1304605063,1,3
5344,1304605059,1304605060,1304605064,1,4
5345,1304605059,1304605060,1304605064,1,4
5346,1304605059,1304605060,1304605064,1,4
5347,1304605059,1304605060,1304605064,1,4
5348,1304605059,1304605060,1304605064,1,4
5349,1304605059,1304605060,1304605068,1,8
5350,1304605059,1304605060,1304605064,1,4
5351,1304605059,1304605120,1304605124,61,4
5352,1304605059,1304605120,1304605124,61,4
5353,1304605059,1304605120,1304605124,61,4
5354,1304605059,1304605120,1304605124,61,4
5355,1304605059,1304605120,1304605124,61,4
5356,1304605059,1304605120,1304605123,61,3
5357,1304605059,1304605120,1304605124,61,4
5358,1304605059,1304605120,1304605124,61,4
5359,1304605059,1304605135,1304605139,76,4
5360,1304605059,1304605135,1304605139,76,4
5361,1304605059,1304605135,1304605138,76,3
5362,1304605059,1304605135,1304605139,76,4
5363,1304605059,1304605150,1304605154,91,4
5364,1304605059,1304605150,1304605154,91,4
5365,1304605059,1304605150,1304605154,91,4
5366,1304605059,1304605150,1304605155,91,5
5367,1304605059,1304605150,1304605156,91,6
5368,1304605060,1304605150,1304605156,90,6
5369,1304605060,1304605150,1304605155,90,5
5370,1304605060,1304605150,1304605152,90,2
5371,1304605060,1304605180,1304605184,120,4
5372,1304605060,1304605180,1304605186,120,6
5373,1304605060,1304605180,1304605186,120,6
5374,1304605060,1304605180,1304605185,120,5
5375,1304605060,1304605195,1304605211,135,16
5376,1304605060,1304605195,1304605202,135,7
5377,1304605060,1304605195,1304605202,135,7
5378,1304605060,1304605195,1304605208,135,13
5379,1304605060,1304605195,1304605198,135,3
5380,1304605060,1304605195,1304605198,135,3
5381,1304605060,1304605195,1304605199,135,4
5387,1304605773,1304605780,1304605784,7,4
5388,1304605773,1304605780,1304605782,7,2
5389,1304605773,1304605780,1304605784,7,4
5390,1304605773,1304605780,1304605784,7,4
5383,1304605773,1304605780,1304605784,7,4
5384,1304605773,1304605780,1304605783,7,3
5385,1304605773,1304605780,1304605784,7,4
5386,1304605773,1304605780,1304605784,7,4
5391,1304605773,1304605840,1304605844,67,4
5392,1304605773,1304605840,1304605844,67,4
5393,1304605773,1304605840,1304605844,67,4
5394,1304605773,1304605840,1304605848,67,8
5395,1304605773,1304605855,1304605858,82,3
5396,1304605773,1304605855,1304605859,82,4
5397,1304605773,1304605855,1304605858,82,3
5398,1304605773,1304605855,1304605858,82,3
5399,1304605773,1304605870,1304605874,97,4
5400,1304605773,1304605870,1304605874,97,4
5401,1304605773,1304605870,1304605873,97,3
5402,1304605773,1304605870,1304605874,97,4
5403,1304605773,1304605900,1304605904,127,4
5404,1304605773,1304605900,1304605905,127,5
5405,1304605773,1304605900,1304605904,127,4
5406,1304605773,1304605900,1304605904,127,4
5407,1304605773,1304605915,1304605919,142,4
5408,1304605773,1304605915,1304605919,142,4
5409,1304605773,1304605915,1304605919,142,4
5410,1304605773,1304605915,1304605919,142,4
5411,1304605773,1304605930,1304605936,157,6
5412,1304605774,1304605930,1304605937,156,7
5413,1304605774,1304605930,1304605937,156,7
5414,1304605774,1304605930,1304605936,156,6
5415,1304605774,1304605960,1304605963,186,3
5416,1304605774,1304605960,1304605964,186,4
5417,1304605774,1304605960,1304605967,186,7
5418,1304605774,1304605960,1304605967,186,7
5419,1304605774,1304605975,1304605980,201,5
5420,1304605774,1304605975,1304605991,201,16
5421,1304605774,1304605975,1304605982,201,7
5422,1304605774,1304605975,1304605982,201,7
5423,1304605774,1304605990,1304606002,216,12
5424,1304605774,1304605990,1304605993,216,3
5425,1304605774,1304605990,1304605994,216,4
5426,1304605774,1304605990,1304605994,216,4
5298,1304256486,1304256550,1304608301,64,351751
5427,1304606414,1304606425,1304609344,11,2919
5428,1304606425,1304606440,1304609347,15,2907
5429,1304609483,1304609485,1304609487,2,2
5333,1304597222,1304597230,1304609648,8,12418
5334,1304597501,1304597516,1304612229,15,14713
5433,1304611533,1304612245,1304612250,712,5
5430,1304609516,1304609530,1304628396,14,18866
5327,1304585664,1304585666,1304630139,2,44473
5434,1304612801,1304612815,1304632042,14,19227
5431,1304609526,1304609575,1304636806,49,27231
5432,1304609892,1304609905,1304655871,13,45966
5329,1304595736,1304595745,1304665614,9,69869
5447,1304676957,1304676970,1304676974,13,4
5448,1304676958,1304676970,1304676974,12,4
5449,1304676958,1304676970,1304676974,12,4
5450,1304676958,1304676970,1304676979,12,9
5455,1304676958,1304676970,1304676974,12,4
5456,1304676958,1304676970,1304676974,12,4
5457,1304676958,1304676970,1304676974,12,4
5458,1304676958,1304676970,1304676974,12,4
5451,1304676958,1304676970,1304676974,12,4
5452,1304676958,1304676970,1304676974,12,4
5453,1304676958,1304676970,1304676974,12,4
5454,1304676958,1304676970,1304676974,12,4
5439,1304676957,1304676970,1304676974,13,4
5440,1304676957,1304676970,1304676974,13,4
5441,1304676957,1304676970,1304676974,13,4
5442,1304676957,1304676970,1304676974,13,4
5443,1304676957,1304676970,1304676974,13,4
5444,1304676957,1304676970,1304676973,13,3
5445,1304676957,1304676970,1304676974,13,4
5446,1304676957,1304676970,1304676974,13,4
5459,1304676958,1304677015,1304677019,57,4
5460,1304676958,1304677015,1304677019,57,4
5461,1304676958,1304677015,1304677019,57,4
5462,1304676958,1304677015,1304677018,57,3
5463,1304676958,1304677015,1304677019,57,4
5464,1304676958,1304677015,1304677019,57,4
5465,1304676958,1304677015,1304677018,57,3
5466,1304676958,1304677015,1304677019,57,4
5467,1304676958,1304677045,1304677051,87,6
5468,1304676958,1304677045,1304677052,87,7
5469,1304676958,1304677045,1304677053,87,8
5470,1304676958,1304677045,1304677051,87,6
5471,1304676958,1304677045,1304677048,87,3
5472,1304676958,1304677045,1304677049,87,4
5473,1304676958,1304677045,1304677052,87,7
5474,1304676958,1304677045,1304677052,87,7
5475,1304676958,1304677045,1304677050,87,5
5476,1304676958,1304677045,1304677061,87,16
5477,1304676958,1304677045,1304677052,87,7
5478,1304676958,1304677045,1304677052,87,7
5479,1304676958,1304677060,1304677072,102,12
5480,1304676958,1304677060,1304677063,102,3
5481,1304676958,1304677060,1304677064,102,4
5482,1304676958,1304677060,1304677064,102,4
5487,1304690539,1304690545,1304690548,6,3
5488,1304690622,1304690635,1304690638,13,3
5486,1304690436,1304690440,1304690831,4,391
5490,1304690850,1304690860,1304691414,10,554
5491,1304691019,1304691460,1304691608,441,148
5492,1304691114,1304691625,1304693830,511,2205
5489,1304690811,1304690815,1304698097,4,7282
5493,1304691253,1304693860,1304702917,2607,9057
5483,1304677494,1304677495,1304704613,1,27118
5484,1304678527,1304678530,1304710838,3,32308
5305,1304347899,1304348060,1304715895,161,367835
5438,1304669236,1304669246,1304718432,10,49186
5382,1304605337,1304605345,1304742128,8,136783
5308,1304348159,1304348525,1304748889,366,400364
5485,1304678680,1304704660,1304750805,25980,46145
5495,1304752214,1304752227,1304752229,13,2
5496,1304752421,1304752435,1304752537,14,102
5497,1304752476,1304752480,1304752567,4,87
5498,1304752869,1304752870,1304753056,1,186
5499,1304753415,1304753425,1304753647,10,222
5500,1304753662,1304753665,1304753669,3,4
5501,1304753868,1304753875,1304753954,7,79
5502,1304754099,1304754100,1304754103,1,3
5503,1304754579,1304754580,1304754583,1,3
5504,1304755362,1304755376,1304755380,14,4
5505,1304755780,1304755795,1304755799,15,4
5506,1304755856,1304755870,1304755873,14,3
5435,1304665624,1304665669,1304755943,45,90274
5507,1304756247,1304756260,1304756273,13,13
5508,1304756264,1304756275,1304756288,11,13
5509,1304757714,1304757715,1304757727,1,12
5510,1304757832,1304757835,1304757838,3,3
5511,1304757982,1304757985,1304757992,3,7
5512,1304758125,1304758135,1304758145,10,10
5513,1304758280,1304758286,1304758301,6,15
5514,1304758384,1304758390,1304758498,6,108
5515,1304758520,1304758525,1304758553,5,28
5516,1304758950,1304758960,1304759833,10,873
5518,1304760600,1304760611,1304760612,11,1
5519,1304760639,1304760640,1304760640,1,0
5494,1304692012,1304698135,1304761074,6123,62939
5523,1304761511,1304761525,1304761528,14,3
5524,1304761774,1304761780,1304761783,6,3
5522,1304761154,1304761165,1304762002,11,837
5525,1304762315,1304762320,1304762343,5,23
5526,1304762473,1304762486,1304762491,13,5
5332,1304596498,1304596510,1304766965,12,170455
5527,1304774809,1304774815,1304775010,6,195
5528,1304775320,1304775325,1304775513,5,188
5529,1304776010,1304776015,1304776068,5,53
5530,1304776858,1304776870,1304776930,12,60
5531,1304777295,1304777305,1304777418,10,113
5532,1304777303,1304777305,1304777523,2,218
5533,1304777831,1304777845,1304777865,14,20
5534,1304778250,1304778265,1304778282,15,17
5535,1304778293,1304778296,1304778310,3,14
5536,1304778590,1304778595,1304778676,5,81
5437,1304666046,1304666050,1304808920,4,142870
5517,1304760511,1304760520,1304841101,9,80581
5323,1304492274,1304613205,1304844070,120931,230865
5538,1304836993,1304837005,1304857243,12,20238
5539,1304838912,1304838925,1304899149,13,60224
5537,1304836683,1304836690,1304900889,7,64199
5542,1304937703,1304937715,1304937847,12,132
5541,1304936842,1304936845,1304940610,3,3765
5543,1305032417,1305032425,1305032430,8,5
5544,1305032506,1305032516,1305032520,10,4
5545,1305033390,1305033400,1305033404,10,4
5546,1305036730,1305036745,1305036946,15,201
5548,1305039266,1305039280,1305039283,14,3
5549,1305039784,1305039790,1305039793,6,3
5550,1305040195,1305040210,1305040213,15,3
5540,1304839121,1304839135,1305058378,14,219243
5436,1304665748,1304665750,1305101945,2,436195
5551,1305105140,1305105145,1305105207,5,62
5553,1305105960,1305105971,1305106033,11,62
5552,1305105617,1305105625,1305106475,8,850
5554,1305106451,1305106465,1305106655,14,190
5557,1305116277,1305116290,1305116383,13,93
5558,1305130019,1305130030,1305130034,11,4
5561,1305130439,1305130450,1305130455,11,5
5562,1305130439,1305130450,1305130454,11,4
5575,1305130439,1305130450,1305130455,11,5
5576,1305130439,1305130450,1305130455,11,5
5573,1305130439,1305130450,1305130454,11,4
5574,1305130439,1305130450,1305130455,11,5
5563,1305130439,1305130450,1305130455,11,5
5564,1305130439,1305130450,1305130454,11,4
5567,1305130439,1305130450,1305130455,11,5
5568,1305130439,1305130450,1305130455,11,5
5571,1305130439,1305130450,1305130455,11,5
5572,1305130439,1305130450,1305130455,11,5
5577,1305130439,1305130450,1305130454,11,4
5578,1305130439,1305130450,1305130454,11,4
5565,1305130439,1305130450,1305130455,11,5
5566,1305130439,1305130450,1305130455,11,5
5569,1305130439,1305130451,1305130463,12,12
5570,1305130439,1305130451,1305130458,12,7
5559,1305130438,1305130450,1305130454,12,4
5560,1305130438,1305130450,1305130454,12,4
5579,1305130439,1305130510,1305130514,71,4
5580,1305130439,1305130510,1305130514,71,4
5583,1305130439,1305130510,1305130514,71,4
5584,1305130439,1305130510,1305130514,71,4
5581,1305130439,1305130510,1305130514,71,4
5582,1305130439,1305130510,1305130513,71,3
5585,1305130439,1305130510,1305130514,71,4
5586,1305130439,1305130510,1305130514,71,4
5587,1305130439,1305130510,1305130515,71,5
5588,1305130439,1305130510,1305130515,71,5
5589,1305130439,1305130525,1305130529,86,4
5590,1305130439,1305130525,1305130530,86,5
5591,1305130439,1305130525,1305130529,86,4
5592,1305130439,1305130525,1305130531,86,6
5593,1305130439,1305130525,1305130530,86,5
5594,1305130439,1305130525,1305130529,86,4
5595,1305130439,1305130526,1305130544,87,18
5596,1305130439,1305130526,1305130531,87,5
5597,1305130439,1305130540,1305130547,101,7
5598,1305130439,1305130540,1305130547,101,7
5599,1305130439,1305130540,1305130544,101,4
5600,1305130439,1305130540,1305130545,101,5
5601,1305130439,1305130540,1305130544,101,4
5602,1305134792,1305134800,1305134804,8,4
5603,1305134792,1305134800,1305134804,8,4
5604,1305134792,1305134800,1305134804,8,4
5605,1305134792,1305134800,1305134804,8,4
5606,1305134792,1305134800,1305134806,8,6
5607,1305134793,1305134800,1305134808,7,8
5608,1305134793,1305134800,1305134814,7,14
5556,1305108732,1305108745,1305168084,13,59339
5609,1305190810,1305190825,1305190834,15,9
5610,1305198687,1305198701,1305198706,14,5
5614,1305198932,1305198941,1305198966,9,25
5615,1305198932,1305198940,1305198945,8,5
5611,1305198932,1305198941,1305198946,9,5
5612,1305198932,1305198941,1305198949,9,8
5613,1305198932,1305198941,1305198947,9,6
5617,1305198932,1305199030,1305199035,98,5
5618,1305198932,1305199045,1305199051,113,6
5616,1305198932,1305199030,1305199036,98,6
5619,1305198932,1305199061,1305199068,129,7
5620,1305198932,1305199061,1305199066,129,5
5622,1305198932,1305199120,1305199125,188,5
5621,1305198932,1305199120,1305199127,188,7
5623,1305198932,1305199150,1305199155,218,5
5624,1305198932,1305199181,1305199188,249,7
5625,1305198932,1305199181,1305199186,249,5
5626,1305198932,1305199210,1305199215,278,5
5627,1305198933,1305199240,1305199246,307,6
5628,1305198933,1305199270,1305199275,337,5
5629,1305198933,1305199301,1305199308,368,7
5630,1305198933,1305199301,1305199307,368,6
5631,1305198933,1305199330,1305199336,397,6
5632,1305198933,1305199360,1305199365,427,5
5633,1305198933,1305199390,1305199395,457,5
5634,1305198933,1305199421,1305199447,488,26
5635,1305198933,1305199421,1305199427,488,6
5636,1305198933,1305199450,1305199456,517,6
5637,1305198933,1305199480,1305199486,547,6
5638,1305198933,1305199510,1305199516,577,6
5639,1305198933,1305199541,1305199548,608,7
5640,1305198933,1305199541,1305199547,608,6
5641,1305198933,1305199570,1305199575,637,5
5642,1305198933,1305199600,1305199607,667,7
5643,1305198933,1305199630,1305199635,697,5
5644,1305198933,1305199661,1305199670,728,9
5645,1305198933,1305199661,1305199667,728,6
5646,1305198933,1305199690,1305199696,757,6
5647,1305198933,1305199720,1305199731,787,11
5648,1305198933,1305199750,1305199775,817,25
5649,1305198933,1305199781,1305199798,848,17
5650,1305198933,1305199781,1305199788,848,7
5651,1305198933,1305199810,1305199815,877,5
5654,1305198980,1305199900,1305199904,920,4
5652,1305198933,1305199840,1305199845,907,5
5653,1305198933,1305199870,1305199876,937,6
5655,1305199519,1305199901,1305199909,382,8
5656,1305200747,1305200755,1305200763,8,8
5657,1305202309,1305202315,1305202320,6,5
5658,1305202846,1305202855,1305203685,9,830
5659,1305215393,1305215395,1305215395,2,0
5660,1305215443,1305215455,1305215455,12,0
5661,1305215530,1305215545,1305215545,15,0
5662,1305216036,1305216040,1305216040,4,0
5663,1305216319,1305216325,1305216328,6,3
5664,1305222186,1305222190,1305222190,4,0
5665,1305222452,1305222460,1305222460,8,0
5666,1305222499,1305222505,1305222505,6,0
5667,1305222840,1305222850,1305222850,10,0
5668,1305223267,1305223270,1305223270,3,0
5669,1305223316,1305223330,1305223331,14,1
5670,1305224695,1305224710,1305224710,15,0
5671,1305225166,1305225175,1305225175,9,0
5672,1305225232,1305225235,1305225235,3,0
5673,1305225623,1305225625,1305225625,2,0
5674,1305225780,1305225790,1305225790,10,0
5675,1305226027,1305226030,1305226030,3,0
5676,1305226508,1305226510,1305226510,2,0
5677,1305227978,1305227980,1305227980,2,0
5678,1305228092,1305228100,1305228100,8,0
5679,1305228216,1305228220,1305228220,4,0
5680,1305228284,1305228295,1305228295,11,0
5681,1305228363,1305228370,1305228370,7,0
5682,1305228457,1305228460,1305228460,3,0
5683,1305229466,1305229480,1305229480,14,0
5684,1305229558,1305229570,1305229570,12,0
5331,1304595831,1304595835,1305272434,4,676599
5686,1305272628,1305272635,1305272635,7,0
5689,1305274566,1305274571,1305274875,5,304
5690,1305275398,1305275410,1305275414,12,4
5691,1305276043,1305276055,1305276058,12,3
5694,1305276850,1305276865,1305276868,15,3
5692,1305276768,1305276775,1305280187,7,3412
5695,1305285351,1305285355,1305285433,4,78
5696,1305285596,1305285610,1305285613,14,3
5697,1305285798,1305285805,1305285811,7,6
5698,1305287166,1305287171,1305287178,5,7
5699,1305287201,1305287215,1305287233,14,18
5700,1305287255,1305287260,1305287280,5,20
5702,1305287324,1305287335,1305287342,11,7
5701,1305287292,1305287305,1305287386,13,81
5703,1305287871,1305287875,1305287879,4,4
5704,1305287941,1305287950,1305287957,9,7
5705,1305288262,1305288265,1305288273,3,8
5706,1305288921,1305288925,1305288944,4,19
5707,1305288990,1305289001,1305289011,11,10
5709,1305294348,1305294355,1305294377,7,22
5708,1305294340,1305294355,1305294427,15,72
5711,1305297313,1305297325,1305297328,12,3
5712,1305297400,1305297415,1305297418,15,3
5713,1305299266,1305299275,1305299280,9,5
5714,1305299703,1305299710,1305299713,7,3
5715,1305299915,1305299920,1305299923,5,3
5716,1305299971,1305299980,1305300020,9,40
5717,1305301414,1305301421,1305301430,7,9
5693,1305276801,1305276805,1305306465,4,29660
4875,1301136934,1301141285,1305321541,4351,4180256
5720,1305370507,1305370510,1305373293,3,2783
5721,1305373264,1305373270,1305373274,6,4
5722,1305373296,1305373300,1305373304,4,4
5723,1305373656,1305373660,1305373686,4,26
5719,1305308752,1305308755,1305374611,3,65856
5718,1305308744,1305308755,1305388302,11,79547
5728,1305393572,1305393580,1305393608,8,28
5724,1305388036,1305388046,1305446776,10,58730
4446,1298901502,1298901515,1305446943,13,6545428
5319,1304419371,1304419385,1305447073,14,1027688
5318,1304419368,1304419370,1305447120,2,1027750
5726,1305388277,1305388285,1305452566,8,64281
5732,1305455594,1305455605,1305455630,11,25
5733,1305455763,1305455770,1305455777,7,7
5734,1305455936,1305455950,1305455976,14,26
5735,1305456917,1305456926,1305456951,9,25
5736,1305458099,1305458110,1305458115,11,5
5737,1305461725,1305461740,1305461745,15,5
5738,1305461874,1305461875,1305461888,1,13
5739,1305461963,1305461965,1305461983,2,18
5740,1305467819,1305467830,1305468432,11,602
5742,1305472600,1305472615,1305472630,15,15
5741,1305472448,1305472451,1305472657,3,206
5743,1305472680,1305472690,1305472745,10,55
5744,1305474379,1305474385,1305474738,6,353
5745,1305475811,1305475825,1305475830,14,5
5746,1305475863,1305475870,1305475874,7,4
5747,1305475911,1305475915,1305475919,4,4
5748,1305476277,1305476291,1305476297,14,6
5749,1305476666,1305476680,1305476684,14,4
5750,1305476715,1305476725,1305476729,10,4
5752,1305479052,1305479065,1305479069,13,4
5753,1305479173,1305479185,1305479300,12,115
5754,1305479425,1305479441,1305479446,16,5
5755,1305479525,1305479530,1305479534,5,4
5756,1305479605,1305479620,1305479623,15,3
5757,1305479674,1305479680,1305479684,6,4
5758,1305479730,1305479740,1305479744,10,4
5759,1305480346,1305480355,1305480358,9,3
5760,1305480983,1305480986,1305481049,3,63
5761,1305481110,1305481120,1305482427,10,1307
5751,1305476930,1305476935,1305484781,5,7846
5727,1305388318,1305388330,1305495950,12,107620
5685,1305272460,1305272470,1305535175,10,262705
5762,1305535637,1305535645,1305535649,8,4
5763,1305539657,1305539665,1305539669,8,4
5764,1305542212,1305542215,1305542219,3,4
5765,1305547167,1305547181,1305547189,14,8
5766,1305547669,1305547675,1305547679,6,4
5555,1305108645,1305108655,1305548645,10,439990
5767,1305548692,1305548695,1305548699,3,4
5770,1305550591,1305550601,1305550641,10,40
5771,1305552224,1305552235,1305552240,11,5
5769,1305550536,1305550540,1305552299,4,1759
5772,1305555942,1305555955,1305555961,13,6
5773,1305556066,1305556075,1305556084,9,9
5774,1305556402,1305556405,1305556409,3,4
5775,1305556511,1305556525,1305556530,14,5
5776,1305556604,1305556615,1305556620,11,5
5777,1305556853,1305556855,1305556858,2,3
5778,1305557079,1305557080,1305557089,1,9
5779,1305557591,1305557605,1305557615,14,10
5768,1305548915,1305548920,1305560781,5,11861
5780,1305560772,1305560785,1305560788,13,3
5260,1303981003,1303981010,1305566958,7,1585948
5781,1305621999,1305622000,1305622065,1,65
5782,1305624392,1305624400,1305624418,8,18
5785,1305624459,1305624460,1305624467,1,7
5786,1305624465,1305624475,1305624483,10,8
5783,1305624446,1305624461,1305624467,15,6
5784,1305624454,1305624461,1305624467,7,6
5788,1305625543,1305625555,1305625581,12,26
5787,1305625540,1305625555,1305625597,15,42
5789,1305626054,1305626065,1305626069,11,4
5790,1305626222,1305626230,1305626260,8,30
5791,1305628715,1305628720,1305628740,5,20
5792,1305628723,1305628735,1305628755,12,20
5793,1305634127,1305634135,1305634138,8,3
5794,1305634132,1305634135,1305634138,3,3
5795,1305634256,1305634270,1305634275,14,5
5796,1305634260,1305634270,1305634273,10,3
5797,1305634344,1305634345,1305634349,1,4
5798,1305634442,1305634450,1305634453,8,3
5799,1305634513,1305634525,1305634538,12,13
5800,1305634642,1305634645,1305634650,3,5
5801,1305635452,1305635455,1305635460,3,5
5802,1305639219,1305639220,1305639224,1,4
5803,1305639610,1305639625,1305639638,15,13
5804,1305639614,1305639625,1305639638,11,13
5805,1305639717,1305639730,1305639732,13,2
5806,1305639720,1305639730,1305639733,10,3
5807,1305639722,1305639730,1305639733,8,3
5808,1305640034,1305640045,1305640049,11,4
5809,1305640821,1305640825,1305640828,4,3
5810,1305640829,1305640840,1305640844,11,4
5811,1305640856,1305640870,1305640873,14,3
5812,1305640993,1305641005,1305641008,12,3
5814,1305641020,1305641035,1305641038,15,3
5813,1305641017,1305641020,1305641024,3,4
5815,1305641152,1305641155,1305641158,3,3
5816,1305641155,1305641170,1305641173,15,3
5817,1305641157,1305641170,1305641174,13,4
5818,1305641364,1305641365,1305641368,1,3
5819,1305641378,1305641380,1305641383,2,3
5820,1305641403,1305641410,1305641413,7,3
5821,1305641436,1305641440,1305641443,4,3
5822,1305641503,1305641515,1305641518,12,3
5823,1305641573,1305641575,1305641578,2,3
5824,1305641602,1305641605,1305641609,3,4
5825,1305641653,1305641665,1305641668,12,3
5826,1305641738,1305641740,1305641742,2,2
5827,1305641868,1305641875,1305641877,7,2
5828,1305642018,1305642025,1305642028,7,3
5829,1305642135,1305642145,1305642149,10,4
5830,1305642499,1305642505,1305642518,6,13
5831,1305642506,1305642520,1305642533,14,13
5832,1305642556,1305642565,1305642569,9,4
5833,1305643295,1305643300,1305643303,5,3
5834,1305643300,1305643315,1305643330,15,15
5835,1305643349,1305643360,1305643364,11,4
5836,1305643422,1305643435,1305643460,13,25
5837,1305643426,1305643435,1305643482,9,47
5838,1305653277,1305653291,1305653298,14,7
5839,1305653510,1305653515,1305653587,5,72
5840,1305655386,1305655390,1305655393,4,3
5841,1305655489,1305655495,1305655498,6,3
5842,1305655571,1305655585,1305655589,14,4
5688,1305272856,1305447145,1305684421,174289,237276
5843,1305697754,1305697765,1305697773,11,8
5844,1305697876,1305697885,1305697890,9,5
5845,1305698226,1305698230,1305698234,4,4
5846,1305698233,1305698245,1305698252,12,7
5847,1305698292,1305698305,1305698309,13,4
5848,1305698662,1305698665,1305698668,3,3
5849,1305698667,1305698680,1305698683,13,3
5850,1305698751,1305698755,1305698790,4,35
5851,1305698799,1305698800,1305698809,1,9
5852,1305698916,1305698920,1305698931,4,11
5853,1305698950,1305698965,1305699015,15,50
5854,1305699204,1305699205,1305699313,1,108
5855,1305699245,1305699250,1305699282,5,32
5856,1305700048,1305700060,1305700085,12,25
5857,1305700080,1305700090,1305700096,10,6
5858,1305700345,1305700360,1305700364,15,4
5859,1305700495,1305700510,1305700513,15,3
5861,1305700721,1305700735,1305700910,14,175
5864,1305701337,1305701350,1305701385,13,35
5866,1305702248,1305702250,1305702254,2,4
5867,1305702277,1305702281,1305702556,4,275
5868,1305702899,1305702910,1305702913,11,3
5869,1305703263,1305703270,1305703273,7,3
5870,1305703431,1305703435,1305703515,4,80
5860,1305700655,1305700660,1305704130,5,3470
5871,1305704307,1305704320,1305704323,13,3
5872,1305704434,1305704440,1305704442,6,2
5873,1305704501,1305704515,1305704518,14,3
5874,1305704637,1305704651,1305704655,14,4
5875,1305704723,1305704725,1305704728,2,3
5876,1305704793,1305704800,1305704803,7,3
5877,1305704879,1305704890,1305704893,11,3
5878,1305704963,1305704965,1305705009,2,44
5879,1305705142,1305705145,1305705207,3,62
5731,1305447150,1305447160,1305706896,10,259736
5730,1305447146,1305447160,1305707065,14,259905
5880,1305707662,1305707665,1305707668,3,3
5881,1305707716,1305707725,1305707728,9,3
5882,1305707890,1305707905,1305707909,15,4
5883,1305708191,1305708205,1305708210,14,5
5884,1305709198,1305709210,1305709214,12,4
5885,1305709458,1305709465,1305709469,7,4
5886,1305709578,1305709585,1305709590,7,5
5887,1305709605,1305709615,1305709619,10,4
5888,1305709776,1305709780,1305709784,4,4
5889,1305709812,1305709825,1305709832,13,7
5890,1305709920,1305709930,1305709934,10,4
5891,1305717957,1305717970,1305717976,13,6
5892,1305717964,1305717970,1305717979,6,9
5893,1305717968,1305717970,1305717977,2,7
5895,1305717987,1305718000,1305718005,13,5
5894,1305717975,1305717986,1305717993,11,7
5290,1304155842,1304155850,1305772908,8,1617058
5687,1305272642,1305272650,1305775531,8,502881
5897,1305792227,1305792237,1305792238,10,1
5899,1305792267,1305792280,1305792280,13,0
5900,1305792429,1305792431,1305795114,2,2683
5902,1305808922,1305808930,1305808933,8,3
5904,1305809950,1305809965,1305809968,15,3
5903,1305809948,1305809950,1305809953,2,3
5710,1305297107,1305297115,1305811746,8,514631
5905,1305811377,1305811390,1305811905,13,515
5725,1305388059,1305388060,1305811905,1,423845
5907,1305811932,1305811945,1305811971,13,26
5908,1305811936,1305811945,1305811966,9,21
5912,1305812059,1305812065,1305812066,6,1
5917,1305814403,1305814405,1305814420,2,15
5915,1305814402,1305814405,1305814416,3,11
5918,1305814404,1305814405,1305814421,1,16
5914,1305814395,1305814405,1305814414,10,9
5916,1305814402,1305814405,1305814419,3,14
5520,1304760706,1304760715,1305830078,9,1069363
5901,1305792477,1305792490,1305861727,13,69237
5920,1305870059,1305870070,1305870180,11,110
5921,1305870559,1305870565,1305870576,6,11
5922,1305871063,1305871075,1305871099,12,24
5924,1305871432,1305871435,1305871440,3,5
5925,1305871444,1305871451,1305871458,7,7
5923,1305871422,1305871435,1305871440,13,5
5927,1305871455,1305871465,1305871470,10,5
5928,1305871461,1305871465,1305871491,4,26
5926,1305871452,1305871467,1305871473,15,6
5929,1305871468,1305871480,1305871485,12,5
5933,1305871896,1305871900,1305871920,4,20
5932,1305871893,1305871900,1305871944,7,44
5935,1305871907,1305871915,1305871946,8,31
5931,1305871890,1305871900,1305871958,10,58
5936,1305871921,1305871930,1305871983,9,53
5937,1305871925,1305871930,1305871981,5,51
5934,1305871904,1305871915,1305871920,11,5
5930,1305871590,1305871600,1305873254,10,1654
5939,1305873455,1305873460,1305873496,5,36
5941,1305873462,1305873475,1305873500,13,25
5940,1305873458,1305873460,1305873550,2,90
5942,1305873466,1305873475,1305873523,9,48
5943,1305873473,1305873475,1305873532,2,57
5938,1305873451,1305873460,1305873577,9,117
5944,1305873478,1305873490,1305873546,12,56
5945,1305873884,1305873895,1305873950,11,55
5946,1305874538,1305874541,1305874674,3,133
5947,1305875062,1305875065,1305875090,3,25
5948,1305875260,1305875275,1305875312,15,37
5949,1305877260,1305877270,1305877307,10,37
5862,1305700871,1305700885,1305885747,14,184862
5951,1305882432,1305882447,1305892323,15,9876
5953,1305882689,1305892406,1305907800,9717,15394
5955,1305885457,1305885461,1305910716,4,25255
5954,1305883304,1305907856,1305933650,24552,25794
5300,1304257614,1304257625,1305933991,11,1676366
5952,1305882481,1305882493,1305947939,12,65446
5956,1305885642,1305885679,1305954618,37,68939
5961,1305902307,1305933701,1305958448,31394,24747
5959,1305885950,1305885955,1305976941,5,90986
5906,1305811499,1305811510,1305983201,11,171691
5964,1305982973,1305982975,1306001498,2,18523
5963,1305982837,1305982840,1306028144,3,45304
5966,1306053916,1306053925,1306054726,9,801
5965,1306053913,1306053927,1306054720,14,793
5973,1306060986,1306060990,1306061363,4,373
5978,1306061525,1306061530,1306061531,5,1
5865,1305702003,1305702010,1306061870,7,359860
5272,1304019431,1304019440,1306062166,9,2042726
5274,1304064464,1304064470,1306062229,6,1997759
5968,1306054770,1306054780,1306066761,10,11981
3715,1295968989,1295974265,1306067141,5276,10092876
5967,1306054765,1306054780,1306074007,15,19227
5971,1306056422,1306056430,1306082914,8,26484
5975,1306061399,1306061411,1306085722,12,24311
5976,1306061490,1306061500,1306085715,10,24215
5980,1306061895,1306066795,1306086366,4900,19571
5986,1306082811,1306082816,1306090071,5,7255
5969,1306054867,1306054870,1306095101,3,40231
5983,1306068607,1306068611,1306119795,4,51184
5950,1305882391,1305882401,1306130858,10,248457
5993,1306130869,1306130877,1306130884,8,7
5996,1306132967,1306132978,1306138227,11,5249
5977,1306061504,1306061515,1306141782,11,80267
5911,1305812055,1305812065,1306142351,10,330286
5998,1306135837,1306142380,1306142383,6543,3
5997,1306133828,1306133832,1306145120,4,11288
5999,1306147133,1306147137,1306147139,4,2
5972,1306057474,1306057480,1306148044,6,90564
5995,1306131071,1306131086,1306150855,15,19769
6002,1306148333,1306148335,1306151613,2,3278
6003,1306148337,1306148353,1306155211,16,6858
5910,1305812052,1305812065,1306155722,13,343657
6005,1306150603,1306150617,1306157415,14,6798
5974,1306061201,1306061215,1306160085,14,98870
5981,1306068078,1306068085,1306160082,7,91997
6004,1306148356,1306148365,1306161291,9,12926
6006,1306150733,1306150901,1306161402,168,10501
6008,1306161495,1306161506,1306161880,11,374
6009,1306161901,1306161911,1306162816,10,905
5985,1306082001,1306082950,1306167956,949,85006
5989,1306085919,1306085920,1306168008,1,82088
5521,1304760752,1304760760,1306177314,8,1416554
5987,1306085040,1306085740,1306183842,700,98102
6007,1306161396,1306161402,1306185247,6,23845
6010,1306162666,1306162870,1306186005,204,23135
5863,1305700947,1305700960,1306190176,13,489216
5990,1306086322,1306086400,1306191534,78,105134
5988,1306085914,1306085920,1306200835,6,114915
5994,1306131007,1306131013,1306212704,6,81691
5991,1306086348,1306095145,1306215190,8797,120045
6015,1306222746,1306222750,1306224137,4,1387
6013,1306222606,1306222615,1306224460,9,1845
6011,1306222459,1306222465,1306224606,6,2141
6017,1306222864,1306222870,1306224697,6,1827
6026,1306226067,1306226080,1306226081,13,1
6016,1306222803,1306222810,1306226615,7,3805
6014,1306222668,1306222675,1306227548,7,4873
6029,1306226890,1306226905,1306227637,15,732
6021,1306226016,1306226020,1306228180,4,2160
6020,1306226011,1306226020,1306228342,9,2322
6031,1306227367,1306228363,1306228585,996,222
6028,1306226722,1306226725,1306229694,3,2969
6032,1306228577,1306228602,1306229915,25,1313
6033,1306229836,1306229966,1306230067,130,101
6035,1306230996,1306231000,1306231487,4,487
6027,1306226105,1306226110,1306232065,5,5955
6038,1306231022,1306232110,1306232600,1088,490
6039,1306231027,1306232620,1306233143,1593,523
6036,1306231005,1306231015,1306234198,10,3183
6019,1306226006,1306226020,1306234373,14,8353
6037,1306231010,1306231525,1306234658,515,3133
6030,1306227188,1306227192,1306234988,4,7796
6047,1306231098,1306235065,1306235090,3967,25
6025,1306226057,1306226065,1306235390,8,9325
6045,1306231083,1306235065,1306235938,3982,873
6012,1306222534,1306222540,1306236369,6,13829
6040,1306231040,1306233190,1306237141,2150,3951
6022,1306226021,1306226036,1306237547,15,11511
6043,1306231066,1306234690,1306240224,3624,5534
6053,1306240937,1306240945,1306240946,8,1
6051,1306240931,1306240945,1306240946,14,1
5992,1306086442,1306141825,1306241854,55383,100029
6048,1306231106,1306235125,1306241938,4019,6813
6041,1306231051,1306234240,1306242238,3189,7998
6023,1306226035,1306226050,1306242272,15,16222
6044,1306231076,1306235065,1306247592,3989,12527
6024,1306226043,1306226050,1306247913,7,21863
6056,1306242588,1306242595,1306248644,7,6049
6055,1306242510,1306242520,1306249154,10,6634
6046,1306231090,1306235065,1306249522,3975,14457
6061,1306243147,1306248686,1306252202,5539,3516
6057,1306243126,1306243135,1306252472,9,9337
6049,1306239011,1306239026,1306252496,15,13470
6060,1306243143,1306247980,1306257566,4837,9586
6042,1306231061,1306234390,1306257611,3329,23221
6058,1306243129,1306247620,1306258074,4491,10454
6034,1306230080,1306230086,1306261142,6,31056
6066,1306255924,1306255930,1306261414,6,5484
6052,1306240934,1306240945,1306261780,11,20835
6064,1306244570,1306244575,1306275844,5,31269
6067,1306264280,1306264286,1306279520,6,15234
6063,1306244283,1306244290,1306279558,7,35268
5982,1306068083,1306068086,1306289117,3,221031
5958,1305885782,1305885790,1306297984,8,412194
6070,1306310552,1306310560,1306310563,8,3
6072,1306310559,1306310560,1306310563,1,3
6074,1306310594,1306310605,1306311960,11,1355
6068,1306308161,1306308176,1306313006,15,4830
5984,1306069798,1306069810,1306313426,12,243616
6069,1306308217,1306308222,1306316490,5,8268
6071,1306310556,1306310560,1306316523,4,5963
6080,1306311644,1306311655,1306319151,11,7496
6088,1306317983,1306317985,1306322177,2,4192
6085,1306313864,1306313876,1306322634,12,8758
5970,1306056205,1306056220,1306322728,15,266508
6086,1306317499,1306317505,1306324552,6,7047
5957,1305885723,1305885730,1306325489,7,439759
6089,1306318259,1306318273,1306329794,14,11521
6090,1306328655,1306328665,1306331551,10,2886
5896,1305792103,1305792115,1306332609,12,540494
6091,1306334433,1306334440,1306335718,7,1278
6094,1306334671,1306334680,1306336524,9,1844
6092,1306334512,1306334515,1306336836,3,2321
6093,1306334668,1306334680,1306338239,12,3559
6099,1306338436,1306338445,1306338445,9,0
6097,1306338426,1306338430,1306339617,4,1187
6096,1306338423,1306338430,1306340533,7,2103
6100,1306338439,1306338445,1306341587,6,3142
6073,1306310562,1306310575,1306341680,13,31105
6101,1306338442,1306338445,1306343182,3,4737
6065,1306244574,1306244575,1306344470,1,99895
6103,1306338449,1306338460,1306344847,11,6387
5962,1305982732,1305982735,1306346156,3,363421
6106,1306348360,1306348375,1306348388,15,13
6109,1306348533,1306348540,1306348561,7,21
6108,1306348529,1306348540,1306348591,11,51
6107,1306348526,1306348540,1306348675,14,135
6110,1306350480,1306350490,1306350625,10,135
6111,1306350604,1306350610,1306350623,6,13
6077,1306311564,1306311565,1306350764,1,39199
6112,1306350763,1306350775,1306351043,12,268
6113,1306350846,1306350850,1306351111,4,261
6116,1306351051,1306351060,1306351238,9,178
6115,1306351010,1306351015,1306351370,5,355
6117,1306351104,1306351105,1306351507,1,402
6118,1306351160,1306351165,1306351599,5,434
6114,1306350940,1306350955,1306355178,15,4223
6098,1306338429,1306338430,1306357831,1,19401
6018,1306222891,1306222900,1306362625,9,139725
6104,1306338501,1306338505,1306366066,4,27561
6105,1306338551,1306338565,1306366626,14,28061
6084,1306313350,1306313365,1306383112,15,69747
5979,1306061650,1306061665,1306395199,15,333534
6119,1306395186,1306395190,1306396034,4,844
6120,1306395881,1306395895,1306398879,14,2984
6000,1306147702,1306147705,1306402171,3,254466
6082,1306313285,1306313290,1306404901,5,91611
6001,1306147888,1306147900,1306405542,12,257642
6128,1306402900,1306402915,1306409391,15,6476
6129,1306403032,1306403035,1306410748,3,7713
6127,1306401054,1306401056,1306414083,2,13027
6087,1306317502,1306322755,1306414880,5253,92125
6054,1306240940,1306240945,1306417356,5,176411
6050,1306239975,1306239985,1306425258,10,185273
6131,1306416817,1306416821,1306430752,4,13931
6136,1306432521,1306432529,1306435128,8,2599
6123,1306396058,1306396060,1306441353,2,45293
6075,1306311556,1306311565,1306448813,9,137248
6124,1306396133,1306396135,1306453485,2,57350
6076,1306311559,1306311565,1306463617,6,152052
6095,1306336617,1306336630,1306471146,13,134516
6134,1306424850,1306424860,1306478127,10,53267
6137,1306478141,1306478155,1306478158,14,3
6138,1306478189,1306478200,1306478201,11,1
6125,1306396226,1306396240,1306478987,14,82747
6135,1306432380,1306432390,1306479032,10,46642
6146,1306480651,1306480660,1306480661,9,1
6145,1306480646,1306480660,1306480661,14,1
6148,1306481239,1306481245,1306481245,6,0
6144,1306480486,1306480495,1306482274,9,1779
6147,1306481177,1306481185,1306483337,8,2152
6150,1306481378,1306481380,1306483555,2,2175
6142,1306480381,1306480392,1306483961,11,3569
6143,1306480388,1306480390,1306484579,2,4189
6140,1306480372,1306480375,1306485078,3,4703
6141,1306480376,1306480390,1306485451,14,5061
6149,1306481304,1306481305,1306485826,1,4521
6152,1306493327,1306493335,1306493341,8,6
6151,1306492187,1306492196,1306495130,9,2934
6132,1306423643,1306423645,1306495186,2,71541
6153,1306498430,1306498435,1306498443,5,8
6154,1306499149,1306499155,1306499218,6,63
6155,1306499458,1306499470,1306499532,12,62
6130,1306404552,1306404568,1306501548,16,96980
6156,1306503311,1306503326,1306511050,15,7724
6102,1306338444,1306338447,1306513119,3,174672
6062,1306244267,1306244275,1306532644,8,288369
6126,1306397994,1306397995,1306568394,1,170399
6160,1306566680,1306566685,1306569121,5,2436
6162,1306570340,1306570345,1306570350,5,5
6163,1306570402,1306570405,1306570409,3,4
6164,1306570615,1306570630,1306570834,15,204
6166,1306573429,1306573435,1306574955,6,1520
6167,1306589676,1306589680,1306590130,4,450
6168,1306590719,1306590730,1306595627,11,4897
6139,1306478998,1306479010,1306600467,12,121457
5913,1305812247,1305812260,1306619230,13,806970
6172,1306670787,1306670802,1306670812,15,10
6173,1306685553,1306685560,1306685564,7,4
6174,1306688385,1306688395,1306688399,10,4
6175,1306688458,1306688470,1306688737,12,267
6176,1306688514,1306688515,1306688765,1,250
6180,1306688957,1306688965,1306688968,8,3
6181,1306689013,1306689025,1306689029,12,4
6182,1306689069,1306689070,1306689074,1,4
6177,1306688693,1306688695,1306689775,2,1080
6178,1306688747,1306688755,1306689784,8,1029
6179,1306688787,1306688800,1306690788,13,1988
6183,1306693428,1306693435,1306693568,7,133
6186,1306693955,1306693960,1306693964,5,4
6187,1306693998,1306694005,1306694010,7,5
6184,1306693571,1306693585,1306694189,14,604
6188,1306694175,1306694185,1306694189,10,4
6191,1306694728,1306694740,1306695283,12,543
6189,1306694420,1306694425,1306695356,5,931
6190,1306694599,1306694605,1306696295,6,1690
6185,1306693694,1306693705,1306696413,11,2708
6192,1306695128,1306695131,1306698660,3,3529
6193,1306704219,1306704221,1306711885,2,7664
6169,1306597813,1306597825,1306736194,12,138369
6195,1306740308,1306740311,1306740316,3,5
6199,1306742003,1306742005,1306742101,2,96
6133,1306423646,1306423660,1306744421,14,320761
6196,1306740752,1306740760,1306744592,8,3832
6198,1306741682,1306741690,1306745300,8,3610
6200,1306745586,1306745590,1306745591,4,1
6201,1306745662,1306745665,1306745666,3,1
6203,1306745747,1306745755,1306745756,8,1
6202,1306745741,1306745755,1306745777,14,22
6205,1306746445,1306746460,1306746464,15,4
6194,1306738691,1306738705,1306746753,14,8048
6078,1306311567,1306311580,1306750179,13,438599
6207,1306750141,1306750150,1306750324,9,174
6206,1306746579,1306746580,1306751547,1,4967
6208,1306754139,1306754140,1306754141,1,1
6209,1306754910,1306754920,1306754921,10,1
6212,1306755860,1306755866,1306756059,6,193
6210,1306755837,1306755850,1306756131,13,281
6211,1306755858,1306755865,1306756247,7,382
6079,1306311575,1306311580,1306759823,5,448243
6081,1306311666,1306311670,1306760295,4,448625
6197,1306740975,1306740988,1306765935,13,24947
6215,1306770621,1306770626,1306785946,5,15320
6122,1306395974,1306395985,1306804563,11,408578
6159,1306566324,1306566325,1306810685,1,244360
6213,1306759673,1306759675,1306813134,2,53459
6216,1306826885,1306826890,1306826894,5,4
4490,1299150605,1299159635,1306833829,9030,7674194
6121,1306395969,1306395970,1306836070,1,440100
6083,1306313287,1306313290,1306840994,3,527704
6219,1306841126,1306841140,1306843307,14,2167
6223,1306846874,1306846888,1306846977,14,89
6214,1306760205,1306760215,1306848453,10,88238
6230,1306849963,1306849975,1306849977,12,2
6224,1306847000,1306847007,1306855556,7,8549
6226,1306847220,1306847232,1306857753,12,10521
6225,1306847109,1306847111,1306860066,2,12955
6228,1306847458,1306857806,1306864537,10348,6731
6231,1306850350,1306850365,1306864674,15,14309
6229,1306847579,1306860116,1306868072,12537,7956
6165,1306570865,1306570870,1306869111,5,298241
6227,1306847311,1306855632,1306894920,8321,39288
6221,1306842950,1306842955,1306905692,5,62737
6232,1306902654,1306902655,1306908125,1,5470
6234,1306908175,1306908190,1306908191,15,1
6237,1306909374,1306909375,1306909376,1,1
6236,1306909284,1306909285,1306911485,1,2200
6235,1306909241,1306909255,1306911522,14,2267
6222,1306843623,1306843630,1306913321,7,69691
6220,1306841717,1306841725,1306930206,8,88481
6239,1306912941,1306912946,1306937304,5,24358
6238,1306909443,1306909450,1306946557,7,37107
6240,1306913048,1306913052,1306949139,4,36087
6170,1306656923,1306656925,1306955603,2,298678
6241,1306913506,1306913518,1306968656,12,55138
6233,1306908173,1306908175,1306968894,2,60719
6243,1306913687,1306949217,1306974055,35530,24838
6242,1306913598,1306937381,1306978546,23783,41165
6157,1306514843,1306514845,1306991344,2,476499
6245,1307000810,1307000815,1307000846,5,31
6246,1307000875,1307000892,1307001004,17,112
6247,1307000993,1307000995,1307001045,2,50
6248,1307002190,1307002195,1307002223,5,28
6252,1307003596,1307003606,1307003651,10,45
6254,1307003635,1307003650,1307003711,15,61
6255,1307003694,1307003695,1307003741,1,46
6257,1307003769,1307003770,1307003776,1,6
6258,1307003799,1307003800,1307003862,1,62
6259,1307003826,1307003830,1307003920,4,90
6260,1307003857,1307003860,1307003969,3,109
6250,1307003070,1307003080,1307005099,10,2019
6244,1306913784,1306968686,1307005508,54902,36822
6263,1307006466,1307006472,1307006632,6,160
6264,1307006819,1307006830,1307006855,11,25
6266,1307006996,1307007010,1307007010,14,0
6267,1307007634,1307007640,1307007675,6,35
6204,1306746351,1306746356,1307008924,5,262568
6251,1307003099,1307003110,1307010283,11,7173
6271,1307012326,1307012335,1307012336,9,1
6276,1307015401,1307015410,1307016114,9,704
6261,1307005981,1307005990,1307020299,9,14309
6262,1307005985,1307005990,1307021030,5,15040
6275,1307015334,1307015337,1307021719,3,6382
6270,1307008501,1307008510,1307037315,9,28805
6278,1307021926,1307021935,1307038213,9,16278
6249,1307002861,1307002870,1307055143,9,52273
6274,1307015128,1307015140,1307063543,12,48403
6269,1307008459,1307008465,1307065859,6,57394
6273,1307014150,1307014165,1307077486,15,63321
6284,1307091674,1307091686,1307099298,12,7612
6285,1307092498,1307092512,1307103668,14,11156
6290,1307105256,1307105260,1307105261,4,1
6289,1307104996,1307105005,1307107217,9,2212
6287,1307100684,1307100686,1307108630,2,7944
6283,1307088740,1307088746,1307109176,6,20430
6288,1307104369,1307104376,1307112559,7,8183
6297,1307115679,1307115685,1307115686,6,1
6296,1307115650,1307115655,1307115656,5,1
6298,1307115729,1307115730,1307115731,1,1
6295,1307114394,1307114395,1307116813,1,2418
6294,1307114084,1307114095,1307117883,11,3788
6299,1307118512,1307118520,1307121632,8,3112
6293,1307113722,1307113736,1307121932,14,8196
6301,1307126510,1307126515,1307126516,5,1
6300,1307118572,1307118581,1307126643,9,8062
6306,1307127234,1307127235,1307127920,1,685
6305,1307127231,1307127235,1307128888,4,1653
6277,1307019529,1307019536,1307130746,7,111210
6291,1307109952,1307109956,1307148716,4,38760
6308,1307170737,1307170750,1307170825,13,75
6309,1307170811,1307170825,1307170902,14,77
6282,1307028776,1307028790,1307171666,14,142876
6279,1307028267,1307028280,1307171671,13,143391
6302,1307126565,1307126575,1307175499,10,48924
6272,1307013050,1307013055,1307180139,5,167084
6313,1307184050,1307184055,1307184056,5,1
6314,1307185799,1307185810,1307185811,11,1
6286,1307094625,1307094640,1307187091,15,92451
6329,1307187881,1307187895,1307187898,14,3
6330,1307187894,1307187895,1307187899,1,4
6328,1307187878,1307187880,1307187883,2,3
6331,1307187897,1307187910,1307187914,13,4
6334,1307188461,1307188465,1307188470,4,5
6335,1307188464,1307188465,1307188470,1,5
6332,1307188255,1307188271,1307188767,16,496
6333,1307188260,1307188270,1307188791,10,521
6338,1307188839,1307188840,1307188938,1,98
6339,1307188893,1307188900,1307189001,7,101
6336,1307188649,1307188660,1307189251,11,591
6337,1307188660,1307188675,1307189322,15,647
6318,1307187518,1307187520,1307190789,2,3269
6317,1307187515,1307187520,1307191293,5,3773
6320,1307187524,1307187535,1307191689,11,4154
6319,1307187521,1307187535,1307191867,14,4332
6316,1307187512,1307187520,1307191888,8,4368
6326,1307187541,1307187550,1307192058,9,4508
6325,1307187537,1307187550,1307192380,13,4830
6323,1307187532,1307187535,1307192607,3,5072
6321,1307187526,1307187535,1307192821,9,5286
6292,1307113664,1307113678,1307194663,14,80985
6324,1307187534,1307187535,1307200179,1,12644
6327,1307187616,1307190805,1307200699,3189,9894
6322,1307187529,1307187535,1307201092,6,13557
6352,1307201440,1307201455,1307201579,15,124
6353,1307203113,1307203120,1307203203,7,83
6341,1307198563,1307198575,1307203743,12,5168
6344,1307201289,1307201290,1307204551,1,3261
6343,1307201286,1307201290,1307204586,4,3296
6345,1307201292,1307201305,1307204563,13,3258
6342,1307201283,1307201290,1307205025,7,3735
6351,1307201312,1307201320,1307210104,8,8784
6350,1307201309,1307201320,1307210460,11,9140
6348,1307201302,1307201305,1307210709,3,9404
6349,1307201306,1307201320,1307210832,14,9512
6346,1307201295,1307201305,1307210859,10,9554
6347,1307201298,1307201306,1307212380,8,11074
6312,1307178810,1307178821,1307214388,11,35567
6280,1307028435,1307028445,1307228439,10,199994
6311,1307173917,1307173930,1307238896,13,64966
6268,1307008443,1307008450,1307243226,7,234776
6218,1306840952,1306840960,1307246046,8,405086
6360,1307260739,1307260750,1307260751,11,1
6357,1307259845,1307259850,1307261436,5,1586
6354,1307259376,1307259385,1307261492,9,2107
6364,1307263184,1307263195,1307275568,11,12373
6217,1306840945,1306840960,1307275519,15,434559
6315,1307185985,1307185990,1307276936,5,90946
6374,1307286757,1307286760,1307293840,3,7080
6375,1307294896,1307294906,1307294914,10,8
6376,1307296071,1307296076,1307299728,5,3652
5273,1304019688,1304019695,1307300601,7,3280906
6372,1307263684,1307263690,1307301676,6,37986
6377,1307296649,1307296661,1307322105,12,25444
6378,1307306772,1307306787,1307322991,15,16204
6304,1307127079,1307127085,1307326374,6,199289
6307,1307170684,1307170690,1307336402,6,165712
6362,1307261518,1307261530,1307340214,12,78684
6379,1307342156,1307342170,1307342359,14,189
6382,1307342170,1307342185,1307342413,15,228
6381,1307342162,1307342170,1307342455,8,285
6384,1307342176,1307342185,1307342454,9,269
6380,1307342159,1307342170,1307343107,11,937
6303,1307126619,1307126620,1307344960,1,218340
6388,1307345490,1307345500,1307345709,10,209
6390,1307345504,1307345515,1307345889,11,374
6391,1307345510,1307345515,1307346013,5,498
6393,1307345519,1307345530,1307346123,11,593
6389,1307345495,1307345500,1307347094,5,1594
6253,1307003621,1307003635,1307347706,14,344071
6383,1307342173,1307342185,1307348554,12,6369
6396,1307348625,1307348636,1307349346,11,710
6385,1307342403,1307342455,1307350857,52,8402
3414,1293848091,1293848105,1307353826,14,13505721
6158,1306566173,1306566175,1307353885,2,787710
6256,1307003714,1307003725,1307354227,11,350502
6265,1307006825,1307006830,1307354439,5,347609
6404,1307355481,1307355490,1307355496,9,6
6397,1307355433,1307355445,1307355836,12,391
6406,1307355497,1307355505,1307356007,8,502
6398,1307355437,1307355445,1307356054,8,609
6399,1307355439,1307355445,1307356069,6,624
6281,1307028439,1307028445,1307356367,6,327922
6310,1307172098,1307172100,1307356413,2,184313
6355,1307259704,1307259715,1307356452,11,96737
6356,1307259781,1307259790,1307356482,9,96692
6359,1307260333,1307260345,1307356551,12,96206
6361,1307261070,1307261080,1307356595,10,95515
6363,1307263018,1307263030,1307356641,12,93611
6386,1307343525,1307343535,1307359139,10,15604
6403,1307355473,1307355475,1307360280,2,4805
6402,1307355464,1307355476,1307363148,12,7672
6392,1307345513,1307345515,1307363630,2,18115
6405,1307355489,1307355490,1307364127,1,8637
6407,1307361765,1307361775,1307364224,10,2449
6161,1306568240,1306568245,1307364381,5,796136
6369,1307263596,1307263602,1307364381,6,100779
6368,1307263590,1307263600,1307364381,10,100781
6387,1307343529,1307343535,1307364381,6,20846
6400,1307355449,1307355460,1307367796,11,12336
6401,1307355455,1307355460,1307368125,5,12665
6412,1307376473,1307376492,1307376503,19,11
6411,1307376473,1307376492,1307376503,19,11
6418,1307376473,1307376597,1307376603,124,6
6413,1307376473,1307376581,1307376588,108,7
6415,1307376473,1307376581,1307376595,108,14
6416,1307376473,1307376581,1307376597,108,16
6414,1307376473,1307376581,1307376596,108,15
6417,1307376473,1307376596,1307376603,123,7
6419,1307376473,1307376686,1307376693,213,7
6420,1307376473,1307376701,1307376708,228,7
6423,1307376473,1307376701,1307376707,228,6
6422,1307376473,1307376701,1307376717,228,16
6421,1307376473,1307376701,1307376708,228,7
6424,1307376473,1307376717,1307376724,244,7
6425,1307376473,1307376806,1307376831,333,25
6426,1307376473,1307376821,1307376827,348,6
6429,1307376473,1307376821,1307376829,348,8
6428,1307376473,1307376821,1307376828,348,7
6427,1307376473,1307376821,1307376828,348,7
6430,1307376473,1307376836,1307376843,363,7
6431,1307376473,1307376926,1307376933,453,7
6435,1307376474,1307376941,1307376946,467,5
6434,1307376473,1307376941,1307376948,468,7
6433,1307376473,1307376941,1307376946,468,5
6432,1307376473,1307376941,1307376948,468,7
6436,1307376474,1307376956,1307376963,482,7
6437,1307376474,1307377046,1307377052,572,6
6440,1307376474,1307377061,1307377068,587,7
6438,1307376474,1307377061,1307377068,587,7
6441,1307376474,1307377061,1307377070,587,9
6439,1307376474,1307377061,1307377070,587,9
6442,1307376474,1307377077,1307377082,603,5
6443,1307376474,1307377166,1307377174,692,8
6444,1307376474,1307377181,1307377188,707,7
6446,1307376474,1307377181,1307377187,707,6
6447,1307376474,1307377181,1307377193,707,12
6445,1307376474,1307377181,1307377189,707,8
6448,1307376474,1307377196,1307377208,722,12
6449,1307376474,1307377286,1307377292,812,6
6450,1307376474,1307377301,1307377319,827,18
6452,1307376474,1307377301,1307377306,827,5
6453,1307376474,1307377301,1307377310,827,9
6451,1307376474,1307377301,1307377310,827,9
6454,1307376474,1307377316,1307377324,842,8
6455,1307376528,1307377406,1307377413,878,7
6457,1307376528,1307377421,1307377427,893,6
6459,1307376528,1307377421,1307377427,893,6
6456,1307376528,1307377421,1307377429,893,8
6458,1307376528,1307377421,1307377427,893,6
6460,1307376528,1307377436,1307377461,908,25
6461,1307376528,1307377526,1307377532,998,6
6462,1307376528,1307377541,1307377550,1013,9
6463,1307376528,1307377541,1307377547,1013,6
6465,1307376528,1307377541,1307377548,1013,7
6464,1307376528,1307377541,1307377548,1013,7
6466,1307376529,1307377557,1307377563,1028,6
6467,1307376529,1307377646,1307377653,1117,7
6470,1307376529,1307377661,1307377669,1132,8
6468,1307376529,1307377661,1307377676,1132,15
6469,1307376529,1307377661,1307377667,1132,6
6471,1307376529,1307377661,1307377667,1132,6
6472,1307376529,1307377676,1307377684,1147,8
6473,1307376529,1307377767,1307377774,1238,7
6475,1307376529,1307377781,1307377789,1252,8
6474,1307376529,1307377781,1307377789,1252,8
6476,1307376529,1307377781,1307377792,1252,11
6477,1307376529,1307377781,1307377789,1252,8
6478,1307376529,1307377797,1307377803,1268,6
6479,1307376529,1307377887,1307377892,1358,5
6481,1307376529,1307377901,1307377906,1372,5
6482,1307376529,1307377901,1307377907,1372,6
6483,1307376529,1307377901,1307377906,1372,5
6480,1307376529,1307377901,1307377914,1372,13
6485,1307376529,1307378006,1307378013,1477,7
6487,1307376529,1307378021,1307378030,1492,9
6489,1307376529,1307378021,1307378027,1492,6
6488,1307376529,1307378021,1307378026,1492,5
6486,1307376529,1307378021,1307378028,1492,7
6490,1307376529,1307378126,1307378133,1597,7
6492,1307376529,1307378141,1307378149,1612,8
6494,1307376529,1307378141,1307378153,1612,12
6493,1307376529,1307378141,1307378153,1612,12
6491,1307376529,1307378141,1307378149,1612,8
6495,1307376529,1307378246,1307378252,1717,6
6497,1307376529,1307378261,1307378271,1732,10
6496,1307376529,1307378261,1307378279,1732,18
6498,1307376529,1307378261,1307378269,1732,8
6499,1307376529,1307378261,1307378270,1732,9
6500,1307376529,1307378366,1307378374,1837,8
6501,1307376530,1307378381,1307378389,1851,8
6504,1307376530,1307378381,1307378388,1851,7
6503,1307376530,1307378381,1307378388,1851,7
6502,1307376530,1307378381,1307378389,1851,8
6505,1307376530,1307378486,1307378493,1956,7
6506,1307376530,1307378501,1307378507,1971,6
6507,1307376530,1307378501,1307378506,1971,5
6508,1307376530,1307378501,1307378510,1971,9
6509,1307376530,1307378501,1307378507,1971,6
6510,1307376530,1307378606,1307378613,2076,7
6514,1307376530,1307378621,1307378637,2091,16
6511,1307376530,1307378621,1307378628,2091,7
6512,1307376530,1307378621,1307378628,2091,7
6513,1307376530,1307378621,1307378628,2091,7
6515,1307376530,1307378726,1307378733,2196,7
6519,1307376530,1307378741,1307378748,2211,7
6516,1307376530,1307378741,1307378748,2211,7
6518,1307376530,1307378741,1307378747,2211,6
6517,1307376530,1307378742,1307378748,2212,6
6520,1307376530,1307378846,1307378853,2316,7
6524,1307376530,1307378862,1307378869,2332,7
6522,1307376530,1307378861,1307378871,2331,10
6521,1307376530,1307378861,1307378871,2331,10
6523,1307376530,1307378861,1307378868,2331,7
6525,1307376530,1307378966,1307378972,2436,6
6528,1307376530,1307378981,1307378987,2451,6
6526,1307376530,1307378982,1307378988,2452,6
6527,1307376530,1307378981,1307378986,2451,5
6529,1307376530,1307378981,1307378989,2451,8
6530,1307376530,1307379086,1307379093,2556,7
6531,1307376530,1307379101,1307379110,2571,9
6533,1307376530,1307379101,1307379109,2571,8
6534,1307376530,1307379101,1307379106,2571,5
6532,1307376530,1307379102,1307379109,2572,7
6535,1307376530,1307379206,1307379214,2676,8
6536,1307376530,1307379221,1307379228,2691,7
6539,1307376531,1307379222,1307379234,2691,12
6538,1307376530,1307379221,1307379230,2691,9
6537,1307376530,1307379221,1307379229,2691,8
6540,1307376531,1307379327,1307379338,2796,11
6542,1307376531,1307379342,1307379348,2811,6
6541,1307376531,1307379341,1307379346,2810,5
6544,1307376531,1307379341,1307379346,2810,5
6543,1307376531,1307379341,1307379350,2810,9
6545,1307376531,1307379447,1307379453,2916,6
6546,1307376531,1307379462,1307379469,2931,7
6408,1307362682,1307376490,1307380370,13808,3880
6371,1307263682,1307263690,1307380592,8,116902
6410,1307374070,1307376490,1307382813,2420,6323
5269,1303983409,1304165964,1307383746,182555,3217782
5266,1303983400,1303983410,1307383744,10,3400334
6409,1307363764,1307376490,1307384633,12726,8143
6562,1307389588,1307389611,1307389620,23,9
6563,1307389924,1307389930,1307389931,6,1
6564,1307390094,1307390096,1307390102,2,6
6565,1307390625,1307390636,1307390643,11,7
6570,1307391231,1307391235,1307391266,4,31
6566,1307390800,1307390816,1307393514,16,2698
6569,1307391160,1307391177,1307393901,17,2724
6340,1307190556,1307190565,1307406198,9,215633
6577,1307426956,1307426965,1307430150,9,3185
6484,1307376529,1307377917,1307432662,1388,54745
6576,1307426909,1307426920,1307434507,11,7587
6578,1307438984,1307438996,1307439001,12,5
6580,1307454325,1307454340,1307454385,15,45
6581,1307454330,1307454340,1307454680,10,340
6370,1307263600,1307263615,1307455401,15,191786
6579,1307454319,1307454325,1307457742,6,3417
6575,1307425727,1307425743,1307458987,16,33244
6559,1307383502,1307383510,1307459213,8,75703
6568,1307391070,1307391085,1307462644,15,71559
6582,1307454336,1307454340,1307521237,4,66897
6573,1307391541,1307391550,1307524463,9,132913
6593,1307526820,1307526835,1307528189,15,1354
6594,1307526892,1307526895,1307528317,3,1422
6591,1307526110,1307526115,1307528950,5,2835
6592,1307526461,1307526475,1307530658,14,4183
6598,1307532665,1307532670,1307535502,5,2832
6596,1307532477,1307532490,1307536353,13,3863
6597,1307532549,1307532550,1307537545,1,4995
6599,1307535932,1307535940,1307541556,8,5616
6600,1307536218,1307536225,1307541684,7,5459
6595,1307532381,1307532385,1307542771,4,10386
6574,1307425510,1307425525,1307544039,15,118514
6605,1307546313,1307546320,1307546323,7,3
6602,1307542683,1307542690,1307548187,7,5497
6583,1307516758,1307516770,1307548216,12,31446
6601,1307542614,1307542615,1307548677,1,6062
6557,1307383048,1307383060,1307596523,12,213463
6608,1307547034,1307547040,1307597818,6,50778
6558,1307383269,1307383270,1307599897,1,216627
6550,1307382169,1307382175,1307600700,6,218525
6584,1307521215,1307521225,1307600896,10,79671
6607,1307546983,1307546995,1307606072,12,59077
6606,1307546892,1307546905,1307617519,13,70614
6552,1307382194,1307382205,1307619507,11,237302
6619,1307619471,1307619475,1307620696,4,1221
6618,1307619433,1307619445,1307620795,12,1350
6620,1307619500,1307619520,1307621847,20,2327
6614,1307615076,1307615080,1307624419,4,9339
6617,1307619395,1307619400,1307627892,5,8492
6604,1307546006,1307546020,1307628409,14,82389
6622,1307631371,1307631385,1307631390,14,5
6358,1307260086,1307260090,1307633643,4,373553
6623,1307631644,1307631655,1307644994,11,13339
6612,1307600725,1307600740,1307645944,15,45204
6624,1307631711,1307631715,1307648648,4,16933
6616,1307615395,1307615410,1307652453,15,37043
6609,1307547321,1307596555,1307654912,49234,58357
6615,1307615342,1307615350,1307657197,8,41847
6621,1307631239,1307631250,1307662678,11,31428
6588,1307523272,1307523280,1307692455,8,169175
6627,1307646163,1307646175,1307706370,12,60195
6567,1307390965,1307390980,1307708937,15,317957
6572,1307391453,1307391460,1307716922,7,325462
6571,1307391310,1307391325,1307719212,15,327887
6625,1307645925,1307645935,1307782951,10,137016
6547,1307382055,1307382070,1307807625,15,425555
6560,1307383575,1307383585,1307822463,10,438878
6635,1307797165,1307797180,1307830913,15,33733
6634,1307797161,1307797165,1307846943,4,49778
6639,1307867415,1307867426,1307871487,11,4061
6556,1307382244,1307382250,1307872372,6,490122
6640,1307873663,1307873666,1307874513,3,847
6641,1307875620,1307875631,1307875637,11,6
6632,1307796892,1307796895,1307878988,3,82093
6645,1307876567,1307876576,1307879323,9,2747
6642,1307875727,1307875736,1307879616,9,3880
6610,1307547325,1307547340,1307880052,15,332712
6633,1307796897,1307796910,1307880895,13,83985
6555,1307382228,1307382235,1307882329,7,500094
6644,1307876385,1307876396,1307883544,11,7148
6630,1307796766,1307796775,1307883722,9,86947
6643,1307875872,1307875886,1307884506,14,8620
6646,1307882521,1307882531,1307889976,10,7445
6651,1307890074,1307890075,1307890076,1,1
6613,1307609491,1307609500,1307890156,9,280656
6650,1307889041,1307889056,1307890365,15,1309
6652,1307891130,1307891140,1307891141,10,1
6653,1307891497,1307891500,1307891501,3,1
6631,1307796772,1307796775,1307895970,3,99195
6656,1307892717,1307892731,1307896775,14,4044
6655,1307892512,1307892520,1307897613,8,5093
6657,1307895338,1307895340,1307899339,2,3999
6649,1307888260,1307888276,1307901319,16,13043
6659,1307895450,1307895460,1307904350,10,8890
6648,1307888177,1307888186,1307912941,9,24755
6654,1307892397,1307892400,1307915757,3,23357
6669,1307913311,1307913325,1307917879,14,4554
6670,1307913313,1307913325,1307918195,12,4870
6664,1307901030,1307901040,1307920262,10,19222
6663,1307901020,1307901025,1307920642,5,19617
6662,1307901018,1307901025,1307921536,7,20511
6638,1307844847,1307844850,1307922723,3,77873
6671,1307913316,1307913325,1307922716,9,9391
6666,1307911142,1307911150,1307922942,8,11792
6667,1307911263,1307911270,1307929168,7,17898
6658,1307895414,1307895415,1307946076,1,50661
6660,1307895473,1307895475,1307950719,2,55244
6681,1307916065,1307916070,1307952755,5,36685
6673,1307913322,1307913325,1307958121,3,44796
6684,1307965029,1307965031,1307965040,2,9
6685,1307965851,1307965857,1307967269,6,1412
6688,1307970871,1307970880,1307970884,9,4
6689,1307970988,1307971000,1307971005,12,5
6691,1307971241,1307971255,1307971256,14,1
6692,1307971849,1307971855,1307971856,6,1
6611,1307600704,1307600710,1307974250,6,373540
6702,1307976654,1307976655,1307976659,1,4
6703,1307976746,1307976760,1307976766,14,6
6704,1307976851,1307976865,1307976874,14,9
6705,1307976995,1307977000,1307977004,5,4
6706,1307977214,1307977225,1307977228,11,3
6707,1307977231,1307977240,1307977243,9,3
6668,1307911891,1307911900,1307977332,9,65432
6708,1307977711,1307977720,1307977721,9,1
6709,1307977893,1307977900,1307977902,7,2
6710,1307978332,1307978335,1307978338,3,3
6711,1307978579,1307978590,1307978593,11,3
6712,1307978982,1307978995,1307978998,13,3
6687,1307970587,1307970596,1307979738,9,9142
6701,1307976446,1307976460,1307983165,14,6705
6716,1307980940,1307980945,1307987061,5,6116
6695,1307975320,1307975335,1307993028,15,17693
6693,1307974330,1307974345,1307995389,15,21044
6700,1307976279,1307976280,1307998699,1,22419
6699,1307975699,1307975710,1307999344,11,23634
6717,1307985472,1307985476,1307999642,4,14166
6721,1308003927,1308003940,1308006586,13,2646
6718,1307985655,1307987080,1308009325,1425,22245
6719,1307985706,1307999381,1308010969,13675,11588
6672,1307913319,1307913325,1308012301,6,98976
6725,1308014082,1308014095,1308014980,13,885
6726,1308014453,1308014455,1308015138,2,683
6729,1308014885,1308014890,1308015721,5,831
6728,1308014882,1308014890,1308016263,8,1373
6675,1307914330,1307922745,1308018393,8415,95648
6722,1308003938,1308003940,1308022256,2,18316
6720,1307999846,1307999860,1308022278,14,22418
6731,1308015032,1308015040,1308023328,8,8288
6730,1308015029,1308015040,1308024542,11,9502
6674,1307914325,1307920690,1308025342,6365,104652
6677,1307914350,1308018415,1308025561,104065,7146
6678,1307914356,1308022330,1308035276,107974,12946
6690,1307971097,1307971105,1308038658,8,67553
6733,1308035096,1308035112,1308045877,16,10765
6732,1308034972,1308034976,1308047218,4,12242
6696,1307975323,1307975335,1308047413,12,72078
6661,1307895704,1307895715,1308101681,11,205966
6683,1307933004,1307933005,1308108862,1,175857
6680,1307914900,1308025570,1308115932,110670,90362
6734,1308062566,1308115975,1308123107,53409,7132
6626,1307646075,1307646085,1308126369,10,480284
6697,1307975330,1308101695,1308126565,126365,24870
6735,1308097615,1308123130,1308136001,25515,12871
6737,1308149471,1308149485,1308151118,14,1633
6395,1307348402,1307348410,1308153465,8,805055
6736,1308144460,1308144475,1308154944,15,10469
6739,1308155075,1308155080,1308155081,5,1
6741,1308155351,1308155365,1308155949,14,584
6747,1308156616,1308156625,1308156625,9,0
6749,1308160998,1308161005,1308161015,7,10
6745,1308156365,1308156370,1308161367,5,4997
6744,1308156277,1308156280,1308161608,3,5328
6751,1308161581,1308161590,1308161647,9,57
6743,1308156079,1308156085,1308163217,6,7132
6740,1308155277,1308155290,1308164056,13,8766
6636,1307797275,1307797285,1308165669,10,368384
6586,1307521537,1307521540,1308165823,3,644283
6752,1308161670,1308161680,1308167966,10,6286
6748,1308156648,1308156655,1308169341,7,12686
6750,1308161377,1308161380,1308170004,3,8624
6753,1308161755,1308161770,1308170248,15,8478
6738,1308149835,1308149845,1308174706,10,24861
6755,1308175224,1308175225,1308175230,1,5
6756,1308175554,1308175555,1308176852,1,1297
6698,1307975333,1307975335,1308178915,2,203580
6754,1308174897,1308174910,1308183926,13,9016
6757,1308185946,1308185950,1308185953,4,3
6676,1307914339,1307974285,1308190591,59946,216306
6758,1308191996,1308192010,1308192011,14,1
6765,1308195190,1308195205,1308203584,15,8379
6759,1308192024,1308192025,1308203605,1,11580
6548,1307382130,1307382145,1308220907,15,838762
6764,1308195184,1308195190,1308222300,6,27110
6679,1307914894,1308025360,1308231214,110466,205854
6773,1308233688,1308233695,1308238055,7,4360
6777,1308236943,1308236950,1308239350,7,2400
6766,1308231237,1308231250,1308242820,13,11570
6778,1308236978,1308236980,1308243175,2,6195
6776,1308235026,1308235030,1308248391,4,13361
6767,1308231455,1308231460,1308249257,5,17797
6779,1308255487,1308255490,1308255664,3,174
6771,1308232946,1308232960,1308255733,14,22773
6782,1308255920,1308255925,1308256635,5,710
6783,1308258434,1308258445,1308258636,11,191
6715,1307980787,1307980795,1308259007,8,278212
6784,1308258496,1308258505,1308259400,9,895
6769,1308231462,1308231475,1308268040,13,36565
6792,1308270808,1308270820,1308271825,12,1005
6795,1308272430,1308272440,1308272666,10,226
6629,1307796615,1307796625,1308277413,10,480788
6768,1308231458,1308231460,1308286593,2,55133
6789,1308259670,1308259675,1308309063,5,49388
6796,1308272686,1308272695,1308312125,9,39430
6780,1308255686,1308255700,1308318454,14,62754
6802,1308321365,1308321370,1308322952,5,1582
6803,1308321748,1308321760,1308330986,12,9226
6797,1308303894,1308303895,1308332381,1,28486
6805,1308322376,1308331000,1308364782,8624,33782
6807,1308328481,1308364795,1308368736,36314,3941
6800,1308321165,1308321175,1308374184,10,53009
6781,1308255804,1308255805,1308390872,1,135067
6804,1308322373,1308322990,1308391668,617,68678
6809,1308405039,1308405040,1308411458,1,6418
6714,1307980785,1307980795,1308411851,10,431056
6806,1308322384,1308332410,1308411948,10026,79538
6812,1308411647,1308411655,1308429258,8,17603
6774,1308234649,1308234655,1308446036,6,211381
6790,1308259672,1308259675,1308457802,3,198127
6808,1308404779,1308404785,1308461536,6,56751
6811,1308407759,1308407770,1308462468,11,54698
6798,1308310655,1308310660,1308467526,5,156866
6799,1308318991,1308467575,1308467578,148584,3
6813,1308411651,1308411880,1308484728,229,72848
6815,1308490982,1308490990,1308490994,8,4
6816,1308492346,1308492355,1308492359,9,4
6817,1308492436,1308492445,1308492458,9,13
6818,1308496709,1308496720,1308496721,11,1
6786,1308258635,1308268090,1308497730,9455,229640
6819,1308497768,1308497770,1308497770,2,0
6760,1308192110,1308192115,1308500157,5,308042
6791,1308259687,1308259690,1308538319,3,278629
6551,1307382182,1307382190,1308538706,8,1156516
6762,1308194281,1308194290,1308569726,9,375436
6810,1308405224,1308405235,1308580139,11,174904
6827,1308561012,1308561025,1308588969,13,27944
6828,1308561021,1308561026,1308591132,5,30106
6713,1307980782,1307980795,1308591895,13,611100
6823,1308498421,1308498430,1308610746,9,112316
6831,1308577348,1308577360,1308627629,12,50269
6829,1308574853,1308574855,1308630650,2,55795
6835,1308601024,1308601030,1308631225,6,30195
6837,1308618013,1308618025,1308635146,12,17121
6830,1308574986,1308574990,1308647610,4,72620
6628,1307796549,1307796550,1308652388,1,855838
6821,1308498281,1308498295,1308659392,14,161097
6761,1308193586,1308193600,1308660108,14,466508
6794,1308271228,1308271240,1308665762,12,394522
6844,1308666682,1308666685,1308666705,3,20
6845,1308667039,1308667046,1308667046,7,0
6851,1308667644,1308667645,1308667646,1,1
6842,1308666568,1308666580,1308669147,12,2567
6850,1308667052,1308667135,1308678590,83,11455
6841,1308666531,1308666535,1308679971,4,13436
6847,1308667044,1308667046,1308681146,2,14100
6843,1308666579,1308666580,1308682982,1,16402
6853,1308667649,1308678610,1308683066,10961,4456
6856,1308667673,1308683095,1308684659,15422,1564
6852,1308667647,1308669175,1308688811,1528,19636
6858,1308667692,1308688825,1308688826,21133,1
6855,1308667659,1308683005,1308689901,15346,6896
6860,1308669568,1308689935,1308689936,20367,1
6840,1308665781,1308665785,1308699336,4,33551
6682,1307917064,1308035305,1308700471,118241,665166
6859,1308667730,1308688855,1308702599,21125,13744
6846,1308667041,1308667045,1308702985,4,35940
6854,1308667651,1308679990,1308709153,12339,29163
6848,1308667047,1308667060,1308711387,13,44327
6839,1308665770,1308665786,1308712261,16,46475
6822,1308498364,1308498370,1308712649,6,214279
6863,1308747758,1308747760,1308748172,2,412
6864,1308747867,1308747880,1308748396,13,516
6862,1308747707,1308747715,1308748680,8,965
6866,1308748015,1308748030,1308748786,15,756
6872,1308749053,1308749065,1308749230,12,165
6871,1308748952,1308748960,1308749327,8,367
6867,1308748088,1308748090,1308749535,2,1445
6870,1308748793,1308748795,1308749993,2,1198
6868,1308748649,1308748660,1308750147,11,1487
6873,1308749265,1308749275,1308753210,10,3935
6861,1308747628,1308747640,1308753447,12,5807
6869,1308748715,1308748720,1308753480,5,4760
6875,1308751818,1308751825,1308755768,7,3943
6878,1308757878,1308757885,1308758078,7,193
6857,1308667676,1308684685,1308761821,17009,77136
6824,1308536623,1308536635,1308763621,12,226986
6793,1308271220,1308271225,1308768948,5,497723
6876,1308755469,1308755470,1308769534,1,14064
6763,1308194580,1308194590,1308771591,10,577001
6879,1308782651,1308782665,1308786458,14,3793
6880,1308789266,1308789280,1308792020,14,2740
6746,1308156513,1308156520,1308813112,7,656592
6814,1308411865,1308411970,1308822429,105,410459
5330,1304595827,1304595835,1308830545,8,4234710
6884,1308844013,1308844015,1308848337,2,4322
6836,1308601159,1308601165,1308859100,6,257935
6834,1308582420,1308591160,1308863010,8740,271850
6885,1308846466,1308846475,1308898087,9,51612
6888,1308919752,1308919765,1308919790,13,25
6887,1308919727,1308919735,1308921819,8,2084
6820,1308497860,1308497875,1308923404,15,425529
6889,1308923408,1308923411,1308923417,3,6
6890,1308923655,1308923666,1308926594,11,2928
6891,1308929845,1308929860,1308929896,15,36
6896,1308929864,1308929875,1308929918,11,43
6895,1308929861,1308929875,1308929955,14,80
6894,1308929858,1308929860,1308930042,2,182
6897,1308930218,1308930220,1308930235,2,15
6898,1308930334,1308930340,1308930361,6,21
6893,1308929851,1308929860,1308930423,9,563
6899,1308930435,1308930445,1308930472,10,27
6900,1308930555,1308930565,1308930639,10,74
6901,1308930746,1308930760,1308930766,14,6
6902,1308931351,1308931360,1308931367,9,7
6903,1308932458,1308932470,1308932638,12,168
6892,1308929848,1308929860,1308932878,12,3018
6904,1308933780,1308933790,1308933791,10,1
6905,1308933990,1308934000,1308934001,10,1
6874,1308749519,1308749530,1308934449,11,184919
6906,1308934561,1308934570,1308934571,9,1
6907,1308938170,1308938185,1308938185,15,0
6772,1308233425,1308233440,1308943632,15,710192
6838,1308665349,1308665350,1308967843,1,302493
6865,1308747955,1308747970,1308991521,15,243551
6849,1308667050,1308667060,1308996894,10,329834
6589,1307523373,1307523385,1308999940,12,1476555
6909,1309015984,1309015990,1309019023,6,3033
6908,1308938253,1308938260,1309024229,7,85969
6918,1309017853,1309017865,1309035855,12,17990
6647,1307886516,1307886520,1309049276,4,1162756
6924,1309025083,1309025095,1309063368,12,38273
6926,1309027928,1309049322,1309070639,21394,21317
6585,1307521417,1307521429,1309085827,12,1564398
6911,1309016262,1309016275,1309086028,13,69753
6929,1309093919,1309093933,1309097625,14,3692
6927,1309070656,1309070680,1309102406,24,31726
6930,1309098115,1309098132,1309104428,17,6296
6934,1309102543,1309102555,1309109863,12,7308
6928,1309070868,1309070875,1309120471,7,49596
6935,1309158214,1309158221,1309158227,7,6
6723,1308007038,1308007045,1309158511,7,1151466
6936,1309159383,1309159391,1309164443,8,5052
6587,1307521549,1307521555,1309170163,6,1648608
6937,1309170218,1309170221,1309177030,3,6809
6931,1309102095,1309102435,1309179896,340,77461
6941,1309180080,1309180090,1309187411,10,7321
6940,1309177552,1309177555,1309205443,3,27888
6938,1309171255,1309177093,1309221908,5838,44815
6742,1308155703,1308155710,1309244710,7,1089000
6943,1309245851,1309245865,1309245866,14,1
6944,1309246289,1309246300,1309250424,11,4124
6788,1308258732,1308258745,1309251030,13,992285
6942,1309245565,1309245580,1309261591,15,16011
6914,1309017836,1309017850,1309263005,14,245155
6950,1309262678,1309262680,1309263492,2,812
6949,1309250522,1309250530,1309270587,8,20057
6916,1309017846,1309017850,1309271179,4,253329
6954,1309264930,1309271200,1309271201,6270,1
6953,1309264181,1309264195,1309272831,14,8636
6947,1309248716,1309248730,1309277042,14,28312
6957,1309281305,1309281310,1309304626,5,23316
6955,1309265439,1309271230,1309308737,5791,37507
6951,1309264047,1309264060,1309334655,13,70595
6952,1309264067,1309264077,1309335830,10,71753
6910,1309016080,1309016095,1309339807,15,323712
6832,1308577899,1308577900,1309339807,1,761907
6833,1308577904,1308580165,1309339807,2261,759642
6882,1308839374,1308839380,1309339961,6,500581
6965,1309336002,1309339975,1309346925,3973,6950
6975,1309351177,1309351180,1309352073,3,893
6976,1309351180,1309352080,1309352675,900,595
6978,1309351187,1309352725,1309352992,1538,267
6923,1309017931,1309017940,1309355494,9,337554
6980,1309351196,1309353010,1309356512,1814,3502
6985,1309351523,1309356520,1309357324,4997,804
6987,1309351529,1309357360,1309358386,5831,1026
6988,1309351532,1309358410,1309359553,6878,1143
6989,1309351535,1309359565,1309360707,8030,1142
6991,1309351540,1309360720,1309362112,9180,1392
6982,1309351514,1309362130,1309362135,10616,5
6984,1309351520,1309362160,1309362231,10640,71
6983,1309351517,1309362130,1309362264,10613,134
6992,1309351543,1309362250,1309362250,10707,0
6993,1309351546,1309362280,1309362291,10734,11
6960,1309335577,1309335580,1309363351,3,27771
6967,1309338011,1309339840,1309365320,1829,25480
6877,1308756297,1308756310,1309398907,13,642597
6946,1309247550,1309277097,1309421532,29547,144435
6939,1309171299,1309221971,1309421527,50672,199556
6886,1308864160,1308864175,1309421776,15,557601
6977,1309351184,1309421545,1309422575,70361,1030
7001,1309422144,1309422610,1309425066,466,2456
6986,1309351526,1309421605,1309427133,70079,5528
7002,1309425075,1309425100,1309427199,25,2099
6981,1309351199,1309421605,1309427805,70406,6200
4492,1299150863,1299176675,1309431432,25812,10254757
5201,1302599740,1302601910,1309431456,2170,6829546
7005,1309433342,1309433350,1309435467,8,2117
6999,1309367606,1309421546,1309438548,53940,17002
7004,1309428088,1309428100,1309439554,12,11454
6925,1309025280,1309025290,1309441977,10,416687
7007,1309438364,1309438587,1309442672,223,4085
6995,1309360582,1309427215,1309446498,66633,19283
7008,1309438418,1309442727,1309446509,4309,3782
7009,1309438482,1309446567,1309446595,8085,28
7012,1309442066,1309446760,1309447053,4694,293
7013,1309442071,1309446760,1309447094,4689,334
7011,1309441446,1309441450,1309447161,4,5711
6969,1309339880,1309363360,1309454928,23480,91568
7014,1309442191,1309446535,1309457690,4344,11155
6958,1309281688,1309308760,1309463237,27072,154477
7010,1309441362,1309446760,1309473811,5398,27051
6962,1309335780,1309335790,1309474827,10,139037
6966,1309336217,1309346935,1309475828,10718,128893
6920,1309017861,1309017865,1309477634,4,459769
6979,1309351193,1309421545,1309483127,70352,61582
6990,1309351538,1309427170,1309484650,75632,57480
6970,1309339928,1309365385,1309494423,25457,129038
7023,1309528025,1309528030,1309528030,5,0
7024,1309528931,1309528945,1309528945,14,0
7017,1309511484,1309511485,1309534925,1,23440
7015,1309445386,1309447180,1309538631,1794,91451
7003,1309426812,1309427215,1309543745,403,116530
7019,1309522070,1309522075,1309550681,5,28606
7021,1309524636,1309550741,1309550748,26105,7
7022,1309525723,1309550816,1309551773,25093,957
6912,1309017773,1309017775,1309571902,2,554127
7025,1309595800,1309595815,1309595815,15,0
7026,1309595900,1309595905,1309595905,5,0
6603,1307545815,1307545825,1309615032,10,2069207
6932,1309102415,1309104505,1309620173,2090,515668
7027,1309596086,1309596100,1309632001,14,35901
6972,1309339968,1309398940,1309652967,58972,254027
7032,1309683954,1309683955,1309692463,1,8508
6994,1309353774,1309421800,1309693525,68026,271725
7030,1309680611,1309680625,1309727990,14,47365
7016,1309502393,1309502395,1309745524,2,243129
7020,1309524600,1309524612,1309750525,12,225913
7028,1309596128,1309596130,1309774827,2,178697
7041,1309771862,1309771871,1309777032,9,5161
7043,1309772168,1309777105,1309778690,4937,1585
6913,1309017833,1309017835,1309788406,2,770571
7055,1309784943,1309784950,1309792140,7,7190
6922,1309017870,1309017880,1309793491,10,775611
7047,1309777721,1309777735,1309797367,14,19632
7056,1309784951,1309792180,1309797988,7229,5808
7057,1309785036,1309798045,1309799254,13009,1209
7058,1309785091,1309799290,1309799995,14199,705
7059,1309785289,1309800055,1309803453,14766,3398
7060,1309785294,1309803490,1309805571,18196,2081
7063,1309792268,1309805605,1309805608,13337,3
7054,1309779971,1309793530,1309809091,13559,15561
7031,1309682823,1309682830,1309816972,7,134142
7035,1309709443,1309709455,1309819169,12,109714
7061,1309790297,1309819180,1309819180,28883,0
7062,1309791437,1309819225,1309819225,27788,0
7037,1309767850,1309767865,1309819807,15,51942
7036,1309767789,1309767791,1309823397,2,55606
6964,1309335893,1309339825,1309833821,3932,493996
6915,1309017840,1309017850,1309844833,10,826983
7040,1309771784,1309819841,1309845516,48057,25675
7064,1309847432,1309847440,1309847444,8,4
7065,1309848299,1309848310,1309848314,11,4
7068,1309849285,1309849300,1309849304,15,4
7038,1309768030,1309768046,1309851081,16,83035
7074,1309854867,1309854880,1309855228,13,348
7069,1309849352,1309849360,1309856608,8,7248
7075,1309856669,1309856680,1309857054,11,374
7076,1309857076,1309857085,1309857111,9,26
7070,1309849442,1309849450,1309858811,8,9361
7077,1309860997,1309861000,1309861372,3,372
7079,1309862278,1309862290,1309862433,12,143
7080,1309862691,1309862695,1309863019,4,324
7067,1309849242,1309849255,1309866183,13,16928
7066,1309849161,1309849165,1309867212,4,18047
7082,1309871544,1309871545,1309871664,1,119
7081,1309871404,1309871410,1309871793,6,383
7083,1309872152,1309872160,1309872220,8,60
7084,1309872320,1309872325,1309872448,5,123
7085,1309872912,1309872925,1309873048,13,123
7086,1309874389,1309874395,1309875119,6,724
7089,1309882277,1309882285,1309884391,8,2106
7091,1309883250,1309883260,1309888012,10,4752
7039,1309768077,1309768091,1309888531,14,120440
7090,1309883179,1309883185,1309889684,6,6499
7100,1309899570,1309899580,1309903186,10,3606
7096,1309883579,1309883590,1309906562,11,22972
6917,1309017850,1309017865,1309909951,15,892086
6919,1309017856,1309017865,1309911917,9,894052
7092,1309883313,1309883320,1309922328,7,39008
7048,1309777826,1309777840,1309928389,14,150549
7093,1309883360,1309883365,1309932152,5,48787
7101,1309933931,1309933945,1309933950,14,5
7094,1309883414,1309883425,1309936758,11,53333
7099,1309883749,1309888570,1309948572,4821,60002
7106,1309936417,1309936420,1309949697,3,13277
7103,1309935467,1309935475,1309954348,8,18873
7110,1309937090,1309948615,1309957190,11525,8575
7121,1309949231,1309957210,1309957213,7979,3
7119,1309947058,1309954360,1309962080,7302,7720
7122,1309950420,1309957255,1309963046,6835,5791
7123,1309950470,1309962115,1309966520,11645,4405
7097,1309883633,1309884430,1309968391,797,83961
7138,1309963049,1309968430,1309973214,5381,4784
7113,1309940515,1309973230,1309973233,32715,3
7112,1309940445,1309973230,1309973233,32785,3
7137,1309962860,1309966555,1309982641,3695,16086
7139,1309964098,1309973260,1309985995,9162,12735
7095,1309883481,1309883485,1309997299,4,113814
7114,1309942092,1309997351,1309997376,55259,25
7029,1309680473,1309680475,1310001186,2,320711
7115,1309943454,1309997441,1310005744,53987,8303
6881,1308838459,1308838465,1310007955,6,1169490
7107,1309936521,1309936525,1310010883,4,74358
7116,1309943765,1310005841,1310018286,62076,12445
7098,1309883702,1309888030,1310018895,4328,130865
7126,1309959993,1310007985,1310021913,47992,13928
6959,1309281731,1309355515,1310025280,73784,669765
7073,1309851106,1309856620,1310025407,5514,168787
6637,1307797363,1307797375,1310025569,12,2228194
5729,1305446768,1305447115,1310025651,347,4578536
7163,1310025294,1310025610,1310025735,316,125
6549,1307382156,1307382160,1310025811,4,2643651
6921,1309017867,1309017880,1310026173,13,1008293
7117,1309944749,1310018351,1310029777,73602,11426
7140,1309964103,1309982680,1310035810,18577,53130
7120,1309948467,1310029841,1310040064,81374,10223
7143,1309964112,1310021935,1310046872,57823,24937
7141,1309964105,1310001220,1310049528,37115,48308
7157,1310022541,1310025850,1310057294,3309,31444
7166,1310028958,1310057336,1310057404,28378,68
7167,1310028967,1310057455,1310057489,28488,34
7173,1310043481,1310057530,1310057546,14049,16
7142,1309964108,1310018920,1310058384,54812,39464
7125,1309952727,1310040116,1310058378,87389,18262
7151,1310019602,1310058431,1310058446,38829,15
7152,1310020454,1310058490,1310063191,38036,4701
7105,1309936291,1309936300,1310063231,9,126931
7133,1309960037,1310025430,1310064697,65393,39267
7104,1309936170,1309936180,1310065578,10,129398
7153,1310020539,1310058490,1310068728,37951,10238
7108,1309936592,1309936795,1310077581,203,140786
7154,1310020613,1310063230,1310081445,42617,18215
7155,1310021459,1310064719,1310084390,43260,19671
7124,1309951686,1309963090,1310085045,11404,121955
7129,1309960012,1310025850,1310105609,65838,79759
7144,1309964114,1310026195,1310106645,62081,80450
7150,1309964134,1310065615,1310114680,101481,49065
7172,1310041208,1310081515,1310117173,40307,35658
7149,1309964131,1310063260,1310118471,99129,55211
7178,1310109621,1310109625,1310121987,4,12362
7111,1309937161,1309949740,1310122776,12579,173036
7146,1309964121,1310046910,1310129353,82789,82443
7180,1310112146,1310122030,1310129649,9884,7619
7179,1310110535,1310117230,1310130248,6695,13018
7184,1310130956,1310130970,1310141257,14,10287
7187,1310146443,1310146450,1310161560,7,15110
7160,1310022592,1310106670,1310163270,84078,56600
7072,1309849635,1309849645,1310164248,10,314603
7181,1310112573,1310129680,1310164998,17107,35318
7145,1309964118,1310035855,1310176744,71737,140889
7156,1310021668,1310068750,1310178763,47082,110013
7182,1310115568,1310164270,1310184535,48702,20265
7183,1310124399,1310176784,1310187006,52385,10222
7159,1310022549,1310085055,1310189141,62506,104086
7190,1310216619,1310216620,1310216622,1,2
7188,1310216613,1310216620,1310216623,7,3
7189,1310216616,1310216620,1310216623,4,3
7191,1310216622,1310216635,1310216636,13,1
7192,1310216813,1310216815,1310216815,2,0
7193,1310221049,1310221068,1310221073,19,5
7176,1310107324,1310184565,1310224352,77241,39787
7102,1309935317,1309935325,1310224457,8,289132
6963,1309335839,1309335880,1310232972,41,897092
7158,1310022546,1310077600,1310235498,55054,157898
7071,1309849530,1309849540,1310236452,10,386912
7194,1310221244,1310221256,1310240701,12,19445
7136,1309962714,1310236480,1310248358,273766,11878
7195,1310233982,1310248405,1310248406,14423,1
7130,1309960019,1310064715,1310253322,104696,188607
7147,1309964124,1310049550,1310276334,85426,226784
7052,1309779716,1309809145,1310280089,29429,470944
7132,1309960032,1310025310,1310291086,65278,265776
7148,1309964128,1310058400,1310297361,94272,238961
7051,1309779713,1309797400,1310315800,17687,518400
7202,1310319375,1310319386,1310319386,11,0
7203,1310319438,1310319445,1310319447,7,2
7204,1310319633,1310319640,1310319641,7,1
7205,1310319723,1310319730,1310319731,7,1
7206,1310319926,1310319940,1310319941,14,1
7207,1310319930,1310319940,1310319941,10,1
7208,1310320117,1310320120,1310320121,3,1
7211,1310320802,1310320810,1310320810,8,0
7209,1310320796,1310320810,1310320811,14,1
7210,1310320799,1310320810,1310320811,11,1
7214,1310320915,1310320930,1310320931,15,1
7212,1310320909,1310320915,1310320916,6,1
7213,1310320912,1310320915,1310320916,3,1
7215,1310321064,1310321065,1310321067,1,2
7216,1310321069,1310321080,1310321081,11,1
7217,1310321158,1310321170,1310321171,12,1
7218,1310321355,1310321365,1310321365,10,0
7219,1310321545,1310321560,1310321561,15,1
7220,1310322044,1310322055,1310322055,11,0
7221,1310322138,1310322145,1310322146,7,1
7222,1310322189,1310322190,1310322191,1,1
7223,1310322345,1310322355,1310322357,10,2
7224,1310322769,1310322775,1310322776,6,1
7226,1310323051,1310323060,1310323062,9,2
7225,1310323041,1310323045,1310323047,4,2
7227,1310323328,1310323330,1310323332,2,2
7228,1310323333,1310323345,1310323346,12,1
7229,1310323589,1310323600,1310323600,11,0
7230,1310323656,1310323660,1310323661,4,1
7199,1310316254,1310316265,1310333893,11,17628
7201,1310316392,1310316400,1310337645,8,21245
7196,1310315977,1310315980,1310342810,3,26830
7231,1310368174,1310368180,1310368181,6,1
7232,1310368360,1310368375,1310368377,15,2
7233,1310368464,1310368465,1310368467,1,2
7237,1310375470,1310375485,1310389114,15,13629
7239,1310390684,1310390695,1310390697,11,2
7238,1310390658,1310390665,1310390669,7,4
7240,1310390838,1310390845,1310390848,7,3
7241,1310391183,1310391190,1310391193,7,3
7242,1310391412,1310391415,1310391418,3,3
7243,1310391662,1310391670,1310391674,8,4
7244,1310392283,1310392285,1310392288,2,3
7245,1310392542,1310392555,1310392559,13,4
7246,1310392783,1310392795,1310392799,12,4
7247,1310393201,1310393215,1310393219,14,4
7248,1310393462,1310393470,1310393475,8,5
7249,1310393467,1310393470,1310393474,3,4
7235,1310375463,1310375470,1310407418,7,31948
7234,1310375460,1310375470,1310413069,10,37599
7050,1309779438,1309788415,1310426571,8977,638156
7236,1310375466,1310375470,1310426672,4,51202
7186,1310134746,1310141290,1310427331,6544,286041
7161,1310022601,1310114695,1310449582,92094,334887
7034,1309709397,1309709410,1310466998,13,757588
7251,1310453738,1310453740,1310468861,2,15121
7250,1310452983,1310452990,1310483391,7,30401
7254,1310490259,1310490265,1310490266,6,1
7255,1310490592,1310490595,1310490596,3,1
7162,1310022603,1310118505,1310507974,95902,389469
7200,1310316331,1310316340,1310510820,9,194480
7049,1309779399,1309779400,1310552691,1,773291
7260,1310539262,1310539275,1310560667,13,21392
7261,1310539318,1310539330,1310562614,12,23284
7265,1310562567,1310562580,1310572634,13,10054
7018,1309519514,1309519525,1310595519,11,1075994
7263,1310559873,1310559880,1310623710,7,63830
7270,1310638716,1310638720,1310638721,4,1
7271,1310639326,1310639335,1310639335,9,0
7274,1310645843,1310645845,1310648570,2,2725
7276,1310670670,1310670685,1310670686,15,1
7197,1310316025,1310316040,1310679078,15,363038
6968,1309338720,1309421605,1310696261,82885,1274656
7275,1310646030,1310646040,1310709238,10,63198
7253,1310472224,1310472235,1310735200,11,262965
7135,1309962709,1310105650,1310743503,142941,637853
7277,1310673181,1310673190,1310766456,9,93266
7287,1310753781,1310766475,1310768816,12694,2341
7256,1310494492,1310494495,1310797656,3,303161
7288,1310814883,1310814895,1310817526,12,2631
7257,1310494670,1310510845,1310853506,16175,342661
7280,1310711489,1310711500,1310868146,11,156646
7252,1310472219,1310472220,1310879777,1,407557
7281,1310711495,1310711500,1310890776,5,179276
7290,1310891807,1310891815,1310891815,8,0
7293,1310901371,1310901385,1310909472,14,8087
7258,1310494673,1310595567,1310925799,100894,330232
7264,1310562362,1310696276,1310932301,133914,236025
7175,1310107234,1310122795,1310937941,15561,815146
7109,1309937080,1309937095,1310988431,15,1051336
7283,1310711504,1310711515,1310988479,11,276964
6971,1309339932,1309365385,1311013063,25453,1647678
6553,1307382205,1307382220,1311024053,15,3641833
7294,1311055013,1311055015,1311057835,2,2820
7289,1310815172,1310815180,1311094265,8,279085
7033,1309709389,1309709395,1311108219,6,1398824
7273,1310645819,1310645830,1311117693,11,471863
7278,1310710298,1310710300,1311135109,2,424809
7198,1310316070,1310316085,1311152505,15,836420
7306,1311258782,1311258792,1311258799,10,7
7307,1311258863,1311258866,1311258870,3,4
7312,1311270069,1311270070,1311270071,1,1
7313,1311270279,1311270280,1311270420,1,140
7311,1311270056,1311270070,1311270469,14,399
7300,1311257920,1311257935,1311275435,15,17500
7309,1311259081,1311259090,1311279617,9,20527
7299,1311257741,1311257755,1311284804,14,27049
7284,1310711510,1310711515,1311290397,5,578882
7266,1310562736,1310562745,1311296518,9,733773
7301,1311258117,1311258130,1311297002,13,38872
7308,1311259028,1311259030,1311303848,2,44818
7318,1311324609,1311324611,1311324639,2,28
7319,1311325003,1311325015,1311325074,12,59
7320,1311328257,1311328270,1311328354,13,84
7317,1311320784,1311320785,1311361298,1,40513
7316,1311320776,1311320785,1311365578,9,44793
7321,1311329313,1311329320,1311374205,7,44885
7282,1310711501,1310711515,1311383901,14,672386
7303,1311258249,1311258250,1311391057,1,132807
7326,1311332032,1311332035,1311401921,3,69886
7315,1311270478,1311270490,1311405631,12,135141
7314,1311270438,1311270445,1311405670,7,135225
7327,1311332098,1311361345,1311405680,29247,44335
7346,1311406026,1311406030,1311406030,4,0
7349,1311406531,1311406540,1311406540,9,0
7329,1311333240,1311374260,1311411356,41020,37096
7324,1311329814,1311329815,1311417564,1,87749
7356,1311413429,1311413440,1311422248,11,8808
7304,1311258383,1311258385,1311430660,2,172275
7302,1311258167,1311258175,1311436958,8,178783
7325,1311330947,1311330955,1311450987,8,120032
7341,1311336778,1311451000,1311451004,114222,4
7334,1311336250,1311391075,1311451229,54825,60154
7337,1311336476,1311405730,1311459750,69254,54020
7322,1311329518,1311329530,1311465660,12,136130
7345,1311337482,1311465685,1311465689,128203,4
7352,1311406720,1311465730,1311465731,59010,1
7353,1311406860,1311465775,1311465775,58915,0
7354,1311406863,1311465805,1311465805,58942,0
7333,1311336170,1311383920,1311470051,47750,86131
6373,1307263687,1307263692,1311479528,5,4215836
7340,1311336726,1311436990,1311480533,100264,43543
7328,1311332157,1311365590,1311484410,33433,118820
7323,1311329717,1311329725,1311489353,8,159628
7343,1311337082,1311451300,1311506622,114218,55322
7336,1311336401,1311401935,1311562908,65534,160973
7344,1311337401,1311459775,1311577015,122374,117240
7305,1311258513,1311258520,1311577704,7,319184
7339,1311336651,1311417595,1311588122,80944,170527
7360,1311587057,1311587066,1311607685,9,20619
7361,1311616302,1311616315,1311616316,13,1
7362,1311616329,1311616330,1311616331,1,1
7365,1311620333,1311620335,1311620336,2,1
7363,1311620327,1311620335,1311620336,8,1
7364,1311620329,1311620335,1311620336,6,1
7366,1311622897,1311622900,1311622901,3,1
7370,1311632355,1311632365,1311632403,10,38
7338,1311336559,1311411385,1311649075,74826,237690
7372,1311633507,1311633520,1311662387,13,28867
7272,1310645792,1310645800,1311663602,8,1017802
7373,1311633515,1311633520,1311667834,5,34314
7376,1311636082,1311667870,1311667870,31788,0
7377,1311636085,1311667915,1311678432,31830,10517
7375,1311636079,1311663640,1311685282,27561,21642
7379,1311685444,1311685450,1311685592,6,142
7380,1311686668,1311686680,1311686682,12,2
7378,1311636087,1311678475,1311689321,42388,10846
7371,1311632362,1311632365,1311690442,3,58077
7381,1311692579,1311692590,1311693054,11,464
7382,1311695703,1311695710,1311695792,7,82
7383,1311696688,1311696700,1311696803,12,103
7384,1311696935,1311696940,1311697462,5,522
7387,1311704957,1311704965,1311714789,8,9824
7386,1311704946,1311704950,1311723431,4,18481
7389,1311705148,1311723445,1311723446,18297,1
7385,1311704852,1311704860,1311724311,8,19451
7388,1311704995,1311714805,1311724903,9810,10098
7268,1310563891,1310563900,1311743756,9,1179856
7392,1311710755,1311724930,1311755258,14175,30328
7409,1311754722,1311754735,1311755269,13,534
7408,1311720483,1311720490,1311764606,7,44116
7342,1311337022,1311451045,1311770766,114023,319721
7390,1311710748,1311723490,1311785153,12742,61663
7394,1311710764,1311755290,1311786551,44526,31261
7391,1311710752,1311724330,1311786835,13578,62505
7393,1311710758,1311743785,1311806910,33027,63125
7397,1311710774,1311786580,1311817930,75806,31350
7412,1311812956,1311812965,1311828236,9,15271
7367,1311624271,1311624280,1311829798,9,205518
7374,1311634877,1311662410,1311834842,27533,172432
7395,1311710767,1311770785,1311836797,60018,66012
7357,1311577684,1311577690,1311845519,6,267829
7400,1311710796,1311817975,1311848497,107179,30522
7396,1311710770,1311785170,1311850333,74400,65163
7398,1311710784,1311786850,1311854021,76066,67171
7402,1311710806,1311834850,1311865969,124044,31119
7410,1311812149,1311866020,1311866020,53871,0
7399,1311710791,1311806950,1311870782,96159,63832
7298,1311250826,1311250840,1311874201,14,623361
7405,1311710816,1311848545,1311878987,137729,30442
7411,1311812340,1311866050,1311889785,53710,23735
7401,1311710802,1311829840,1311894200,119038,64360
7403,1311710810,1311836830,1311899131,126020,62301
7404,1311710813,1311845545,1311909320,134732,63775
7406,1311710819,1311850375,1311914438,139556,64063
7407,1311710822,1311854050,1311917649,143228,63599
6775,1308234931,1308234940,1311920184,9,3685244
7414,1311846770,1311846775,1311922226,5,75451
7359,1311582384,1311582386,1311926072,2,343686
7358,1311577726,1311577739,1311926139,13,348400
7310,1311259099,1311259105,1311926175,6,667070
7331,1311335059,1311874210,1311954879,539151,80669
7286,1310711610,1310743525,1311966838,31915,1223313
7415,1311926044,1311926050,1311968023,6,41973
7420,1311969690,1311969700,1311969700,10,0
7421,1311969806,1311969820,1311969820,14,0
7423,1311970125,1311970135,1311970135,10,0
7425,1311970614,1311970615,1311970615,1,0
7426,1311970741,1311970753,1311970754,12,1
7422,1311969999,1311970000,1311973085,1,3085
7332,1311335063,1311926095,1311979626,591032,53531
7295,1311055139,1311055150,1312047919,11,992769
7368,1311624274,1311624280,1312050670,6,426390
7428,1312061752,1312061755,1312061756,3,1
7259,1310495032,1310495035,1312084345,3,1589310
7433,1312082434,1312082440,1312093004,6,10564
7434,1312082438,1312082440,1312109138,2,26698
7416,1311926101,1311926110,1312110522,9,184412
7330,1311334152,1311430705,1312120351,96553,689646
7435,1312082442,1312082455,1312126377,13,43922
7432,1312077215,1312077220,1312141429,5,64209
7427,1312046506,1312046515,1312141425,9,94910
7440,1312143687,1312143703,1312143707,16,4
7441,1312143690,1312143700,1312143701,10,1
7443,1312145009,1312145020,1312145020,11,0
7438,1312141470,1312141480,1312148138,10,6658
7437,1312141466,1312141480,1312162909,14,21429
7442,1312144950,1312144960,1312165984,10,21024
7454,1312168530,1312168540,1312168540,10,0
7456,1312169221,1312169230,1312169231,9,1
7453,1312168524,1312168525,1312169746,1,1221
7447,1312162974,1312162975,1312174222,1,11247
7451,1312167009,1312167010,1312224101,1,57091
7452,1312167013,1312167028,1312224106,15,57078
7459,1312224018,1312224025,1312224199,7,174
7347,1311406267,1311954895,1312224448,548628,269553
7292,1310891911,1310891920,1312224520,9,1332600
7457,1312223669,1312223680,1312225918,11,2238
7466,1312235864,1312235875,1312235876,11,1
7458,1312223785,1312223800,1312266018,15,42218
7006,1309433758,1309463245,1312289395,29487,2826150
7417,1311926146,1311926155,1312322267,9,396112
7469,1312284380,1312322290,1312322299,37910,9
6883,1308840103,1308840115,1312323097,12,3482982
7471,1312284964,1312323101,1312325576,38137,2475
7472,1312284998,1312323101,1312340039,38103,16938
7473,1312322844,1312340065,1312455289,17221,115224
7475,1312358891,1312455310,1312456918,96419,1608
7464,1312228039,1312228045,1312464819,6,236774
7477,1312359151,1312464850,1312464926,105699,76
7429,1312062481,1312062490,1312476824,9,414334
7476,1312358928,1312456945,1312479962,98017,23017
7474,1312358713,1312358725,1312483988,12,125263
7463,1312224677,1312289412,1312484438,64735,195026
7481,1312414048,1312464970,1312487627,50922,22657
7445,1312148041,1312148050,1312497156,9,349106
7462,1312224529,1312224535,1312537798,6,313263
7088,1309881588,1309911940,1312539675,30352,2627735
7350,1311406582,1311406585,1312546561,3,1139976
7418,1311926200,1311926215,1312547062,15,620847
7470,1312284751,1312322396,1312547064,37645,224668
7483,1312547543,1312547545,1312547551,2,6
7485,1312549428,1312549435,1312549440,7,5
7468,1312236904,1312266055,1312579340,29151,313285
7369,1311624277,1311624280,1312579498,3,955218
7484,1312547682,1312547696,1312594492,14,46796
7492,1312595377,1312595380,1312604085,3,8705
7491,1312595361,1312595365,1312605628,4,10263
7488,1312579265,1312579271,1312606313,6,27042
7448,1312163242,1312163245,1312611716,3,448471
7486,1312577973,1312577980,1312619396,7,41416
7490,1312579665,1312579675,1312627292,10,47617
7460,1312224307,1312224310,1312630446,3,406136
7467,1312236218,1312236220,1312635909,2,399689
7493,1312603339,1312603345,1312655673,6,52328
7498,1312679538,1312679545,1312679710,7,165
7279,1310710736,1310735230,1312679973,24494,1944743
7351,1311406621,1311406630,1312687129,9,1280499
7495,1312655446,1312655455,1312696421,9,40966
7482,1312484593,1312484605,1312717495,12,232890
7465,1312228057,1312228063,1312739137,6,511074
7297,1311240651,1311240655,1312739257,4,1498602
7053,1309779719,1309816990,1312739355,37271,2922365
7489,1312579371,1312579375,1312751876,4,172501
7505,1312785551,1312785565,1312786281,14,716
7504,1312765018,1312765030,1312791206,12,26176
7507,1312792722,1312792735,1312792838,13,103
7506,1312788827,1312788835,1312823355,8,34520
7285,1310711525,1310711530,1312849370,5,2137840
7509,1312831046,1312831060,1312878186,14,47126
7450,1312163327,1312163335,1312925217,8,761882
7517,1312936937,1312936945,1312936946,8,1
7518,1312945591,1312945600,1312945601,9,1
7479,1312402333,1312476835,1312947838,74502,471003
7523,1312971561,1312971565,1312971987,4,422
7521,1312970325,1312970335,1312972699,10,2364
7522,1312971288,1312971295,1312973778,7,2483
7525,1312971714,1312972720,1312974490,1006,1770
7526,1312971807,1312973800,1312975611,1993,1811
7528,1312972053,1312975645,1312975649,3592,4
7515,1312924507,1312924510,1312978711,3,54201
7527,1312971924,1312974520,1312986249,2596,11729
7529,1312972389,1312975690,1312986825,3301,11135
7530,1312972465,1312978750,1312989508,6285,10758
7531,1312972531,1312986280,1312995038,13749,8758
7508,1312830972,1312947880,1312998329,116908,50449
7532,1312972631,1312986850,1313002965,14219,16115
7455,1312169217,1312224475,1313007119,55258,782644
7536,1312973470,1313003005,1313007991,29535,4986
7533,1312973133,1312989550,1313009261,16417,19711
7524,1312971658,1312972030,1313011299,372,39269
7537,1312973563,1313008045,1313013456,34482,5411
7554,1313005366,1313005375,1313013749,9,8374
7534,1312973309,1312995085,1313017498,21776,22413
7538,1312973791,1313009305,1313017764,35514,8459
7436,1312138964,1312138975,1313017832,11,878857
7543,1312974957,1313017870,1313017874,42913,4
7539,1312974329,1313011315,1313018917,36986,7602
7540,1312974438,1313013520,1313021263,39082,7743
7535,1312973369,1312998355,1313021355,24986,23000
7544,1312975013,1313017946,1313021889,42933,3943
7545,1312975126,1313018950,1313022329,43824,3379
7541,1312974770,1313017525,1313023579,42755,6054
7547,1312978841,1313021410,1313028526,42569,7116
7546,1312978809,1313021320,1313029053,42511,7733
7549,1312978960,1313022355,1313029489,43395,7134
7514,1312924225,1312924240,1313034153,15,109913
7548,1312978928,1313021950,1313034626,43022,12676
7550,1312979001,1313023645,1313035673,44644,12028
7542,1312974875,1313017780,1313037070,42905,19290
7551,1312979040,1313028565,1313041206,49525,12641
7555,1313005369,1313007160,1313041360,1791,34200
7513,1312924136,1312924150,1313044829,14,120679
7557,1313005376,1313034160,1313050666,28784,16506
7553,1313000443,1313029105,1313056958,28662,27853
7563,1313005396,1313050960,1313058785,45564,7825
7558,1313005379,1313035705,1313066251,30326,30546
7559,1313005382,1313037130,1313067812,31748,30682
7569,1313034566,1313070010,1313070010,35444,0
7562,1313005393,1313044855,1313071593,39462,26738
7565,1313005402,1313058805,1313074719,53403,15914
7512,1312915722,1312915735,1313077060,13,161325
7511,1312915171,1312915180,1313078185,9,163005
7556,1313005372,1313029510,1313078711,24138,49201
7571,1313053864,1313077105,1313079932,23241,2827
7573,1313061226,1313079970,1313079974,18744,4
7572,1313053902,1313078920,1313081505,25018,2585
7502,1312739092,1312739380,1313087000,288,347620
7577,1313061875,1313087035,1313089169,25160,2134
7576,1313061780,1313087035,1313089444,25255,2409
7568,1313034218,1313068315,1313090650,34097,22335
7516,1312924602,1312924618,1313091739,16,167121
7579,1313089917,1313089930,1313093470,13,3540
7564,1313005399,1313057005,1313095907,51606,38902
7570,1313053305,1313071615,1313098502,18310,26887
7574,1313061564,1313080045,1313099338,18481,19293
7575,1313061640,1313081545,1313100679,19905,19134
7566,1313005406,1313066440,1313111041,61034,44601
7587,1313091183,1313100730,1313121584,9547,20854
7584,1313091103,1313095930,1313122551,4827,26621
7578,1313089805,1313089810,1313123539,5,33729
7561,1313005389,1313041285,1313123923,35896,82638
7588,1313091207,1313100730,1313123950,9523,23220
7585,1313091129,1313123935,1313147300,32806,23365
7593,1313149327,1313149330,1313149645,3,315
7589,1313091236,1313122015,1313150027,30779,28012
7594,1313151964,1313151970,1313152284,6,314
7591,1313092750,1313124475,1313153481,31725,29006
7592,1313141180,1313141185,1313166973,5,25788
7583,1313090954,1313091790,1313168576,836,76786
7560,1313005386,1313041285,1313172609,35899,131324
7596,1313155031,1313155045,1313212352,14,57307
7500,1312687487,1312717525,1313224271,30038,506746
7595,1313154883,1313154895,1313228722,12,73827
7600,1313183183,1313224315,1313230975,41132,6660
7586,1313091148,1313147335,1313231467,56187,84132
6801,1308321330,1308321340,1313262315,10,4940975
7601,1313183216,1313231005,1313263456,47789,32451
7582,1313090664,1313122570,1313268535,31906,145965
7604,1313183295,1313263480,1313275484,80185,12004
7424,1311970187,1311979660,1313280062,9473,1300402
7609,1313261591,1313280072,1313286768,18481,6696
7581,1313090626,1313093500,1313287000,2874,193500
7419,1311969555,1311969565,1313287946,10,1318381
7607,1313261495,1313268565,1313291507,7070,22942
7598,1313177505,1313286790,1313319888,109285,33098
7611,1313290378,1313319910,1313331942,29532,12032
6933,1309102512,1309102528,1313353759,16,4251231
7612,1313290411,1313331955,1313364442,41544,32487
7597,1313177481,1313231500,1313371188,54019,139688
7622,1313374069,1313374075,1313374339,6,264
7621,1313372790,1313372800,1313376897,10,4097
7623,1313381639,1313381650,1313381657,11,7
7627,1313381654,1313381665,1313381686,11,21
7628,1313381657,1313381665,1313381678,8,13
7625,1313381645,1313381650,1313381719,5,69
7626,1313381651,1313381665,1313381705,14,40
7624,1313381641,1313381650,1313381777,9,127
7603,1313183270,1313364475,1313393646,181205,29171
7617,1313348427,1313348440,1313402289,13,53849
7606,1313208189,1313393680,1313463286,185491,69606
7614,1313291773,1313291785,1313498253,12,206468
7605,1313208182,1313371240,1313537238,163058,165998
6554,1307382216,1307382220,1313541044,4,6158824
7296,1311055389,1311055390,1313548133,1,2492743
7629,1313533103,1313533105,1313553411,2,20306
7630,1313536836,1313536840,1313580371,4,43531
7631,1313612130,1313612140,1313614872,10,2732
7633,1313671834,1313671840,1313671851,6,11
7634,1313680208,1313680210,1313680214,2,4
7635,1313681225,1313681230,1313681234,5,4
7636,1313681976,1313681980,1313681984,4,4
7637,1313683516,1313683525,1313683531,9,6
7638,1313683896,1313683900,1313683905,4,5
7641,1313755212,1313755225,1313755230,13,5
7642,1313758074,1313758075,1313758079,1,4
7643,1313758615,1313758630,1313758633,15,3
7639,1313701355,1313701360,1313762394,5,61034
7644,1313765212,1313765215,1313765218,3,3
7645,1313766851,1313766865,1313766868,14,3
7646,1313767268,1313767270,1313767273,2,3
7649,1313775935,1313775940,1313777670,5,1730
7647,1313775710,1313775715,1313787721,5,12006
7655,1313806180,1313806195,1313806195,15,0
7652,1313806172,1313806180,1313806180,8,0
7654,1313806178,1313806180,1313806180,2,0
7653,1313806175,1313806180,1313806180,5,0
7656,1313806183,1313806195,1313806195,12,0
7657,1313806186,1313806240,1313806240,54,0
7496,1312655640,1312655650,1313807241,10,1151591
7651,1313781813,1313781820,1313823936,7,42116
7640,1313721142,1313721145,1313835980,3,114835
7499,1312682022,1312682035,1313846817,13,1164782
7666,1313868832,1313868836,1313889186,4,20350
7567,1313033321,1313041405,1313911556,8084,870151
7519,1312946024,1312946035,1313938146,11,992111
7670,1313995925,1313995931,1313995934,6,3
7671,1313998192,1313998195,1313998198,3,3
7672,1314001072,1314001075,1314001078,3,3
7673,1314006604,1314006610,1314006613,6,3
7674,1314006677,1314006685,1314006688,8,3
7675,1314007006,1314007015,1314007018,9,3
7676,1314007245,1314007255,1314007297,10,42
7678,1314014065,1314014080,1314014083,15,3
7679,1314015552,1314015565,1314015600,13,35
7680,1314016351,1314016360,1314016363,9,3
7681,1314016492,1314016495,1314016529,3,34
7682,1314016985,1314016990,1314016993,5,3
7683,1314017315,1314017320,1314017323,5,3
7684,1314018173,1314018175,1314018211,2,36
7685,1314018673,1314018685,1314018720,12,35
7658,1313868238,1313868250,1314020018,12,151768
7686,1314019221,1314019225,1314020759,4,1534
7687,1314020735,1314020740,1314020886,5,146
7688,1314020875,1314020890,1314020965,15,75
7668,1313954532,1313954545,1314033658,13,79113
7662,1313868323,1313868325,1314089363,2,221038
7602,1313183253,1313353788,1314090972,170535,737184
7269,1310563953,1310563960,1314095159,7,3531199
7689,1314023372,1314023380,1314098674,8,75294
7691,1314098636,1314098650,1314098692,14,42
7692,1314109178,1314109180,1314109232,2,52
7694,1314109387,1314109390,1314109442,3,52
7620,1313359017,1313359030,1314130769,13,771739
7580,1313090557,1313090680,1314165003,123,1074323
7690,1314043348,1314043360,1314168363,12,125003
7700,1314193660,1314193675,1314193771,15,96
7701,1314194593,1314194606,1314194610,13,4
7702,1314194836,1314194845,1314194848,9,3
7698,1314191933,1314191935,1314197984,2,6049
7348,1311406406,1311966882,1314219146,560476,2252264
7707,1314216680,1314216685,1314230858,5,14173
7664,1313868520,1313868535,1314232769,15,364234
7706,1314210872,1314210880,1314234302,8,23422
7696,1314191846,1314191860,1314236548,14,44688
7710,1314237486,1314237490,1314237495,4,5
7712,1314237798,1314237805,1314237807,7,2
7711,1314237724,1314237730,1314239196,6,1466
7697,1314191877,1314191890,1314248362,13,56472
7618,1313353748,1313353750,1314263135,2,909385
7720,1314265708,1314265720,1314265721,12,1
7721,1314265762,1314265765,1314265769,3,4
7722,1314273747,1314273760,1314273764,13,4
7723,1314274311,1314274315,1314274319,4,4
7703,1314194971,1314194980,1314274931,9,79951
7724,1314275028,1314275035,1314275039,7,4
7725,1314277774,1314277780,1314277784,6,4
7726,1314277847,1314277855,1314277859,8,4
7727,1314278088,1314278095,1314278190,7,95
7728,1314278712,1314278725,1314278819,13,94
7729,1314282526,1314282535,1314282629,9,94
7730,1314283544,1314283555,1314283650,11,95
7708,1314216683,1314230875,1314283296,14192,52421
7731,1314283832,1314283840,1314283936,8,96
7732,1314285039,1314285040,1314285119,1,79
7719,1314262087,1314274975,1314286403,12888,11428
7650,1313776952,1313776960,1314295709,8,518749
7709,1314216687,1314232810,1314296065,16123,63255
7736,1314297721,1314297730,1314315947,9,18217
7738,1314347656,1314347665,1314347758,9,93
7739,1314349229,1314349240,1314349333,11,93
7740,1314349510,1314349525,1314349618,15,93
7733,1314297002,1314297010,1314349300,8,52290
7741,1314349941,1314349945,1314350042,4,97
7742,1314350209,1314350215,1314350320,6,105
7743,1314351872,1314351880,1314351943,8,63
7744,1314352267,1314352270,1314352355,3,85
7718,1314261798,1314263171,1314354579,1373,91408
7745,1314358101,1314358105,1314358184,4,79
7746,1314358284,1314358285,1314358352,1,67
7747,1314358576,1314358585,1314358678,9,93
7748,1314359824,1314359830,1314359908,6,78
7749,1314360766,1314360775,1314360868,9,93
7750,1314361465,1314361480,1314361573,15,93
7751,1314361933,1314361945,1314362023,12,78
7752,1314362230,1314362245,1314362339,15,94
7753,1314362557,1314362560,1314362653,3,93
7754,1314362787,1314362800,1314362881,13,81
7755,1314363063,1314363070,1314363105,7,35
7756,1314363353,1314363355,1314363448,2,93
7734,1314297098,1314297100,1314363523,2,66423
7757,1314363669,1314363670,1314363748,1,78
7758,1314363942,1314363955,1314364048,13,93
7759,1314364188,1314364195,1314364288,7,93
7760,1314364397,1314364405,1314364499,8,94
7761,1314364611,1314364615,1314364693,4,78
7762,1314364939,1314364945,1314365038,6,93
7763,1314365280,1314365290,1314365386,10,96
7764,1314365976,1314365980,1314366074,4,94
7765,1314366721,1314366730,1314366809,9,79
7766,1314367092,1314367105,1314367199,13,94
7767,1314367728,1314367735,1314367829,7,94
7768,1314368120,1314368125,1314368222,5,97
7769,1314368389,1314368395,1314368477,6,82
7669,1313954832,1314219160,1314370490,264328,151330
7444,1312147315,1312147331,1314371751,16,2224420
7608,1313261544,1313275525,1314384222,13981,1108697
7667,1313954437,1313954440,1314391493,3,437053
7716,1314241355,1314241360,1314400016,5,158656
7717,1314259457,1314259468,1314409131,11,149663
7164,1310025743,1310025775,1314423327,32,4397552
7773,1314384998,1314385000,1314425585,2,40585
7659,1313868240,1313868250,1314431066,10,562816
7714,1314238435,1314238450,1314433666,15,195216
7774,1314385217,1314385225,1314437750,8,52525
7776,1314385382,1314385390,1314437591,8,52201
6996,1309360734,1309442020,1314449974,81286,5007954
7461,1312224312,1312224325,1314465851,13,2241526
7778,1314478918,1314478930,1314478931,12,1
7661,1313868320,1313868325,1314545069,5,676744
7770,1314384753,1314384760,1314565224,7,180464
7291,1310891873,1310891875,1314587245,2,3695370
7786,1314607944,1314607945,1314608019,1,74
7787,1314609426,1314609430,1314609526,4,96
7780,1314479706,1314479710,1314610344,4,130634
7788,1314611136,1314611140,1314611219,4,79
7789,1314611500,1314611515,1314611611,15,96
7790,1314615337,1314615340,1314615421,3,81
7791,1314622129,1314622135,1314622215,6,80
7792,1314623519,1314623531,1314623600,12,69
7793,1314624669,1314624670,1314624744,1,74
7794,1314625034,1314625045,1314625138,11,93
7795,1314626454,1314626455,1314626458,1,3
7796,1314626497,1314626500,1314626578,3,78
7797,1314626890,1314626905,1314626908,15,3
7798,1314626931,1314626935,1314627015,4,80
7799,1314627385,1314627400,1314627478,15,78
7800,1314628017,1314628030,1314628099,13,69
7801,1314692854,1314692860,1314692872,6,12
7802,1314694235,1314694240,1314694311,5,71
7803,1314694529,1314694540,1314694589,11,49
7805,1314694765,1314694780,1314694862,15,82
7806,1314696471,1314696475,1314696519,4,44
7807,1314696728,1314696730,1314696790,2,60
7808,1314702531,1314702535,1314702657,4,122
7809,1314702655,1314702670,1314702745,15,75
7810,1314703375,1314703390,1314703461,15,71
7811,1314703487,1314703495,1314703567,8,72
7779,1314479641,1314479650,1314703864,9,224214
7735,1314297205,1314297220,1314727925,15,430705
7520,1312946420,1312946425,1314746168,5,1799743
7813,1314756579,1314756580,1314775959,1,19379
7816,1314777522,1314777535,1314777655,13,120
7737,1314297958,1314315985,1314782741,18027,466756
7814,1314756734,1314756745,1314784397,11,27652
7704,1314195688,1314195700,1314857063,12,661363
7777,1314475721,1314475735,1314906511,14,430776
7818,1314954203,1314954205,1315020579,2,66374
7819,1314954215,1314954220,1315104068,5,149848
7783,1314483813,1314483821,1315126040,8,642219
7785,1314483997,1314484000,1315126638,3,642638
7775,1314385338,1314391510,1315179556,6172,788046
7820,1314954689,1314954700,1315179872,11,225172
7826,1315220455,1315220470,1315220474,15,4
7827,1315220509,1315220515,1315220520,6,5
7828,1315230840,1315230850,1315230854,10,4
7829,1315234812,1315234825,1315234828,13,3
7830,1315234906,1315234915,1315234920,9,5
7831,1315235112,1315235125,1315235130,13,5
7832,1315235762,1315235770,1315235774,8,4
7663,1313868326,1313868340,1315272853,14,1404513
7833,1315297884,1315297885,1315297889,1,4
7834,1315297892,1315297900,1315297903,8,3
7835,1315297898,1315297900,1315297903,2,3
7836,1315299125,1315299130,1315299135,5,5
7837,1315299163,1315299175,1315299180,12,5
7838,1315299194,1315299205,1315299210,11,5
7840,1315300173,1315300180,1315300254,7,74
7839,1315300154,1315300165,1315300340,11,175
7660,1313868243,1313868250,1315345212,7,1476962
7812,1314756204,1314756206,1315358205,2,601999
7841,1315404799,1315404805,1315404808,6,3
7842,1315404895,1315404910,1315404915,15,5
7843,1315405075,1315405090,1315405094,15,4
7817,1314953626,1314953635,1315454954,9,501319
7821,1315126061,1315126075,1315478608,14,352533
7845,1315462984,1315462990,1315484058,6,21068
7846,1315485031,1315485040,1315485200,9,160
7449,1312163246,1312163260,1315493262,14,3330002
7844,1315462873,1315462885,1315505234,12,42349
7705,1314195783,1314195790,1315628230,7,1432440
7848,1315485483,1315628260,1315628261,142777,1
7849,1315562361,1315628260,1315628261,65899,1
7822,1315126744,1315126750,1315652048,6,525298
7494,1312655331,1312680012,1315668834,24681,2988822
7695,1314158194,1314158202,1315733740,8,1575538
7439,1312141707,1312162945,1315735136,21238,3572191
6665,1307910498,1307910505,1315735227,7,7824722
7824,1315215242,1315215250,1315777784,8,562534
7857,1315898413,1315898425,1315898425,12,0
7858,1315898668,1315898680,1315898682,12,2
7859,1315899146,1315899160,1315899707,14,547
7413,1311813509,1311870790,1315899991,57281,4029201
7861,1315900104,1315900105,1315900142,1,37
7860,1315900062,1315900075,1315900284,13,209
7632,1313612265,1313612275,1315900785,10,2288510
7771,1314384789,1314384791,1315900833,2,1516042
7866,1315901002,1315901005,1315901006,3,1
7867,1315901109,1315901110,1315901111,1,1
7503,1312739691,1312751920,1315901482,12229,3149562
7501,1312738635,1312738645,1315903722,10,3165077
7854,1315735189,1315735195,1315903780,6,168585
7853,1315734832,1315735255,1315903806,423,168551
7874,1315903647,1315903795,1315903796,148,1
7875,1315903650,1315903795,1315903796,145,1
7876,1315903657,1315903795,1315903796,138,1
7877,1315903661,1315903795,1315903796,134,1
7878,1315903668,1315903840,1315903840,172,0
7879,1315903671,1315903840,1315903840,169,0
7880,1315903879,1315903885,1315903887,6,2
7881,1315903906,1315903915,1315903916,9,1
7882,1315904000,1315904005,1315904007,5,2
7883,1315904003,1315904005,1315904008,2,3
7884,1315904055,1315904065,1315904069,10,4
7885,1315904057,1315904065,1315904077,8,12
7825,1315215701,1315215715,1315923452,14,707737
7865,1315900947,1315900960,1315927393,13,26433
7610,1313290174,1313291530,1315932508,1356,2640978
7863,1315900462,1315900465,1315934224,3,33759
7782,1314483650,1314565270,1315943849,81620,1378579
7864,1315900907,1315900915,1315956501,8,55586
7888,1315921033,1315932520,1315960358,11487,27838
7889,1315921037,1315943890,1315960828,22853,16938
7784,1314483871,1314483880,1315969301,9,1485421
7886,1315904299,1315904305,1315980164,6,75859
7890,1315932356,1315932370,1315982582,14,50212
7898,1315982253,1315982605,1316009925,352,27320
7892,1315981641,1315981645,1316018972,4,37327
7894,1315981874,1316019010,1316036246,37136,17236
7896,1315982115,1315982125,1316082990,10,100865
7891,1315932593,1315956535,1316086953,23942,130418
7850,1315733763,1315735150,1316092187,1387,357037
7900,1315982880,1315982890,1316120211,10,137321
7851,1315733846,1315733863,1316155400,17,421537
7873,1315902107,1315903825,1316183157,1718,279332
7897,1315982196,1315982201,1316199206,5,217005
7903,1316082531,1316083015,1316209659,484,126644
7904,1316082534,1316086975,1316228271,4441,141296
7907,1316082541,1316099755,1316267588,17214,167833
7913,1316316665,1316316670,1316316670,5,0
7918,1316355638,1316355640,1316355641,2,1
7919,1316355847,1316355850,1316355851,3,1
7920,1316356675,1316356690,1316388663,15,31973
7905,1316082536,1316092210,1316393185,9674,300975
7922,1316389646,1316389660,1316412734,14,23074
7923,1316419784,1316419795,1316421616,11,1821
7925,1316422709,1316422721,1316424533,12,1812
7926,1316443074,1316443075,1316444029,1,954
7927,1316443128,1316443135,1316444709,7,1574
7908,1316082543,1316099785,1316445684,17242,345899
7914,1316316668,1316316670,1316460475,2,143805
7929,1316480306,1316480320,1316480334,14,14
7912,1316316662,1316316670,1316490736,8,174066
7911,1316316658,1316316670,1316504860,12,188190
7915,1316317683,1316317690,1316504880,7,187190
7933,1316505050,1316505055,1316505240,5,185
7932,1316505046,1316505055,1316505232,9,177
7936,1316524987,1316524991,1316524997,4,6
7930,1316480439,1316480440,1316588753,1,108313
7938,1316616014,1316616025,1316618760,11,2735
7935,1316505444,1316505445,1316655846,1,150401
7906,1316082538,1316097790,1316677596,15252,579806
7870,1315901250,1315903765,1316682649,2515,778884
7942,1316682641,1316682655,1316683128,14,473
7943,1316683717,1316683720,1316685478,3,1758
7945,1316696748,1316696755,1316696759,7,4
7893,1315981704,1315981705,1316697233,1,715528
7940,1316650281,1316650285,1316726927,4,76642
7946,1316696885,1316696890,1316749111,5,52221
7939,1316649969,1316677615,1316810984,27646,133369
7823,1315126748,1315126750,1316821370,2,1694620
7948,1316791251,1316791255,1316848222,4,56967
7887,1315921030,1315923505,1316850985,2475,927480
7902,1316013291,1316013295,1316851007,4,837712
7924,1316420030,1316420035,1316851071,5,431036
7934,1316505440,1316505445,1316871302,5,365857
7952,1316848254,1316848255,1316941192,1,92937
7951,1316848251,1316848255,1316941189,4,92934
7954,1316849279,1316851015,1317019251,1736,168236
7961,1317023291,1317023305,1317023306,14,1
7956,1316941235,1316941240,1317092882,5,151642
7928,1316479980,1316479990,1317126850,10,646860
7957,1316941237,1317092920,1317126865,151683,33945
7965,1317127226,1317127240,1317127323,14,83
7949,1316791312,1316791315,1317129553,3,338238
7868,1315901186,1315901200,1317129564,14,1228364
7921,1316388498,1316393230,1317129611,4732,736381
7510,1312849391,1312849405,1317131266,14,4281861
7487,1312578032,1312578040,1317131331,8,4553291
7177,1310107396,1310224405,1317131400,117009,6906995
7969,1317127995,1317129625,1317131633,1630,2008
7964,1317126794,1317129595,1317131706,2801,2111
7497,1312655687,1312655695,1317131903,8,4476208
7947,1316791244,1316791256,1317132058,12,340802
7665,1313868642,1313868655,1317132078,13,3263423
7975,1317132093,1317132100,1317132101,7,1
7971,1317129488,1317131425,1317132218,1937,793
7978,1317132248,1317132250,1317132251,2,1
7910,1316263293,1316263301,1317132391,8,869090
7950,1316791320,1316791330,1317132467,10,341137
7979,1317132365,1317132445,1317142377,80,9932
7980,1317132481,1317132490,1317142407,9,9917
7966,1317127392,1317127405,1317145369,13,17964
7984,1317151531,1317151540,1317151541,9,1
7985,1317151674,1317151675,1317151676,1,1
7983,1317142461,1317142465,1317156762,4,14297
7986,1317151864,1317151870,1317180335,6,28465
7967,1317127396,1317129565,1317200734,2169,71169
6694,1307974556,1307974570,1317204764,14,9230194
7995,1317207136,1317207145,1317207146,9,1
7996,1317207177,1317207190,1317207193,13,3
7815,1314757941,1314757945,1317207731,4,2449786
7999,1317212750,1317212755,1317212758,5,3
8000,1317212953,1317212965,1317213009,12,44
8001,1317213215,1317213220,1317213455,5,235
8003,1317217231,1317217240,1317220176,9,2936
7991,1317198085,1317204820,1317221155,6735,16335
7648,1313775816,1313775820,1317230522,4,3454702
7970,1317129077,1317131350,1317240924,2273,109574
7958,1316941663,1316941675,1317252606,12,310931
7974,1317131773,1317131785,1317280635,12,148850
7976,1317132132,1317132265,1317282584,133,150319
8005,1317285950,1317285955,1317285957,5,2
8006,1317286228,1317286240,1317286243,12,3
8007,1317286237,1317286240,1317286243,3,3
8008,1317286242,1317286255,1317286259,13,4
8009,1317286245,1317286255,1317286259,10,4
8010,1317286484,1317286495,1317286498,11,3
8011,1317286779,1317286780,1317286782,1,2
8012,1317286892,1317286900,1317286903,8,3
8013,1317287295,1317287305,1317287307,10,2
7997,1317207486,1317252640,1317287800,45154,35160
7998,1317207526,1317240955,1317287866,33429,46911
8020,1317295237,1317295240,1317295683,3,443
7862,1315900205,1315900210,1317298357,5,1398147
7955,1316850822,1316941210,1317308503,90388,367293
7992,1317203216,1317207745,1317310346,4529,102601
7959,1316955952,1316955955,1317330934,3,374979
8014,1317287758,1317287905,1317351812,147,63907
8021,1317361380,1317361390,1317361392,10,2
8002,1317216765,1317280675,1317372684,63910,92009
8015,1317287782,1317308545,1317379266,20763,70721
8023,1317380829,1317380830,1317380831,1,1
8024,1317381023,1317381025,1317381026,2,1
8019,1317288813,1317330955,1317392064,42142,61109
7972,1317131207,1317131665,1317392154,458,260489
7960,1316956029,1317126880,1317395171,170851,268291
8028,1317382933,1317392200,1317406006,9267,13806
7990,1317196028,1317200770,1317413966,4742,213196
8030,1317389077,1317406045,1317416324,16968,10279
8031,1317389180,1317413980,1317419801,24800,5821
8027,1317382865,1317392080,1317427077,9215,34997
7989,1317193857,1317193870,1317427329,13,233459
8032,1317389186,1317416365,1317427876,27179,11511
7909,1316223224,1316223238,1317454997,14,1231759
7963,1317114035,1317114040,1317455625,5,341585
8038,1317456999,1317457001,1317457003,2,2
8039,1317457303,1317457316,1317457319,13,3
8029,1317383267,1317395215,1317457849,11948,62634
7895,1315982021,1316036290,1317457998,54269,1421708
8041,1317457755,1317457901,1317458559,146,658
8044,1317462196,1317462206,1317462209,10,3
8045,1317462268,1317462281,1317462284,13,3
8042,1317457919,1317458006,1317465942,87,7936
7982,1317142284,1317142285,1317466276,1,323991
8036,1317454320,1317454331,1317467986,11,13655
8048,1317462975,1317468011,1317475947,5036,7936
8034,1317453636,1317453641,1317480932,5,27291
8046,1317462807,1317466286,1317480975,3479,14689
8047,1317462972,1317465971,1317480991,2999,15020
8004,1317285576,1317285581,1317481014,5,195433
8050,1317481115,1317481121,1317481138,6,17
8049,1317481110,1317481121,1317481131,11,10
8053,1317481270,1317481271,1317481545,1,274
8052,1317481158,1317481166,1317489264,8,8098
7993,1317203303,1317221170,1317496480,17867,275310
8040,1317457663,1317457676,1317500069,13,42393
8056,1317484717,1317484722,1317512796,5,28074
8058,1317543353,1317543357,1317543362,4,5
8017,1317287835,1317298376,1317543870,10541,245494
7590,1313091974,1313123560,1317545030,31586,4421470
8059,1317543531,1317543536,1317545656,5,2120
7953,1316849206,1316849215,1317549873,9,700658
8057,1317541683,1317541691,1317555603,8,13912
8051,1317481153,1317481166,1317557206,13,76040
8054,1317481619,1317481631,1317566858,12,85227
8068,1317557186,1317557201,1317571111,15,13910
8022,1317380503,1317380515,1317625500,12,244985
8071,1317567832,1317571136,1317637469,3304,66333
8070,1317564946,1317566891,1317638427,1945,71536
8076,1317639196,0,0,-1317639196,0
8077,1317639196,0,0,-1317639196,0
8075,1317639196,0,0,-1317639196,0
8078,1317639196,0,0,-1317639196,0
8080,1317639626,0,0,-1317639626,0
8082,1317639626,0,0,-1317639626,0
8079,1317639626,0,0,-1317639626,0
8081,1317639626,0,0,-1317639626,0
8084,1317639765,1317639777,1317639787,12,10
8086,1317639765,1317639777,1317639783,12,6
8083,1317639765,1317639777,1317639787,12,10
8087,1317643908,1317643916,1317643917,8,1
8089,1317651756,1317651761,1317652683,5,922
8091,1317669322,1317669326,1317670210,4,884
8092,1317671084,1317671096,1317671534,12,438
8072,1317624942,1317636401,1317682126,11459,45725
8063,1317544385,1317545696,1317689336,1311,143640
8060,1317543887,1317543897,1317710782,10,166885
8055,1317482170,1317482171,1317715934,1,233763
8090,1317654954,1317654956,1317716748,2,61792
8096,1317717121,1317717131,1317718416,10,1285
8097,1317718594,1317718601,1317718973,7,372
8098,1317718999,1317719006,1317719270,7,264
8035,1317454176,1317454181,1317720720,5,266539
8101,1317720927,1317720941,1317722170,14,1229
8102,1317721309,1317721316,1317723621,7,2305
8104,1317727483,1317727496,1317727838,13,342
8105,1317733408,1317733421,1317734109,13,688
8093,1317710656,1317710666,1317736594,10,25928
8062,1317544109,1317544121,1317746288,12,202167
8061,1317544011,1317544016,1317798225,5,254209
8106,1317803541,1317803546,1317803550,5,4
8107,1317803581,1317803591,1317803600,10,9
8110,1317804083,1317804086,1317804095,3,9
8108,1317803945,1317803951,1317804555,6,604
8109,1317803953,1317803966,1317805070,13,1104
8111,1317804738,1317804747,1317805331,9,584
7981,1317132534,1317132535,1317811818,1,679283
8037,1317454731,1317455051,1317811884,320,356833
7987,1317152043,1317152050,1317812092,7,660042
8018,1317288809,1317310390,1317812776,21581,502386
8033,1317392175,1317419830,1317812770,27655,392940
8117,1317813118,1317813131,1317813133,13,2
8119,1317814814,1317814826,1317814858,12,32
8120,1317815255,1317815261,1317815293,6,32
8122,1317815477,1317815486,1317815491,9,5
8123,1317815649,1317815651,1317816673,2,1022
8094,1317710939,1317710951,1317817337,12,106386
8124,1317816075,1317816086,1317817360,11,1274
8121,1317815390,1317815396,1317882997,6,67601
8069,1317557231,1317557246,1317893374,15,336128
8128,1317889036,1317889046,1317895725,10,6679
8043,1317458577,1317458591,1317955483,14,496892
8067,1317546076,1317549911,1317961367,3835,411456
8129,1317984500,1317984506,1317984510,6,4
8130,1317984852,1317984866,1317984887,14,21
8131,1317984942,1317984956,1317985085,14,129
8132,1317985126,1317985136,1317985181,10,45
8133,1317986382,1317986396,1317986401,14,5
8134,1317986587,1317986591,1317986629,4,38
8135,1317988022,1317988031,1317988070,9,39
8136,1317989958,1317989966,1317989970,8,4
7988,1317193579,1317193586,1317995902,7,802316
8074,1317629512,1317636401,1318042519,6889,406118
7916,1316318141,1316318155,1318054586,14,1736431
8103,1317721498,1317721512,1318058839,14,337327
8142,1318074027,1318074041,1318074047,14,6
8143,1318074318,1318074326,1318074327,8,1
8144,1318074414,1318074416,1318074417,2,1
8100,1317720685,1317720686,1318140486,1,419800
8064,1317544944,1317545066,1318169964,122,624898
8126,1317886538,1317886541,1318193477,3,306936
8145,1318162733,1318162737,1318224599,4,61862
8138,1318064750,1318064756,1318229734,6,164978
8146,1318177188,1318177197,1318234225,9,57028
8150,1318237212,1318237226,1318237238,14,12
8151,1318237416,1318237421,1318237427,5,6
8152,1318238306,1318238321,1318238325,15,4
8140,1318064821,1318064831,1318238979,10,174148
8148,1318177385,1318177391,1318286978,6,109587
8147,1318177381,1318177391,1318290239,10,112848
8139,1318064814,1318064816,1318314028,2,249212
8125,1317817225,1317817226,1318323579,1,506353
8153,1318323526,1318323536,1318323578,10,42
8155,1318323885,1318323896,1318323902,11,6
8157,1318324584,1318324586,1318324618,2,32
8158,1318324740,1318324751,1318324756,11,5
8159,1318329064,1318329071,1318329079,7,8
8160,1318329592,1318329596,1318329600,4,4
8161,1318329784,1318329791,1318329794,7,3
8162,1318330344,1318330346,1318330350,2,4
8163,1318330685,1318330692,1318330785,7,93
8164,1318345651,1318345661,1318348798,10,3137
8137,1318064739,1318064741,1318380862,2,316121
8168,1318405005,1318405016,1318407319,11,2303
8169,1318419227,1318419236,1318419240,9,4
8170,1318419877,1318419881,1318420159,4,278
8173,1318421253,1318421261,1318421313,8,52
8174,1318421619,1318421621,1318421668,2,47
8175,1318421737,1318421741,1318421744,4,3
8178,1318421984,1318421996,1318422115,12,119
8171,1318420528,1318420541,1318422214,13,1673
8176,1318421806,1318421816,1318422227,10,411
8179,1318422240,1318422251,1318422306,11,55
8116,1317812188,1317812202,1318423853,14,611651
8180,1318422593,1318422597,1318424058,4,1461
8172,1318420919,1318420931,1318424207,12,3276
8181,1318424219,1318424231,1318424414,12,183
8182,1318424369,1318424381,1318424469,12,88
8183,1318425375,1318425386,1318425554,11,168
8185,1318432607,1318432616,1318432617,9,1
8184,1318432487,1318432496,1318433018,9,522
8188,1318432828,1318432841,1318433329,13,488
8187,1318432770,1318432781,1318433336,11,555
8186,1318432699,1318432706,1318433489,7,783
8166,1318404273,1318404281,1318434993,8,30712
8095,1317716775,1317716786,1318438290,11,721504
8167,1318404477,1318404491,1318459665,14,55174
8189,1318490385,1318490396,1318491127,11,731
8190,1318490482,1318490487,1318491640,5,1153
8191,1318490521,1318490531,1318492244,10,1713
8127,1317887329,1317887336,1318494255,7,606919
8193,1318493854,1318493861,1318497207,7,3346
8195,1318497536,1318497551,1318497552,15,1
8194,1318497529,1318497536,1318497556,7,20
8196,1318497585,1318497596,1318497603,11,7
8197,1318497590,1318497596,1318497603,6,7
8198,1318497593,1318497596,1318497606,3,10
8199,1318497596,1318497611,1318497629,15,18
8208,1318497685,1318497686,1318497716,1,30
8203,1318497663,1318497671,1318497688,8,17
8204,1318497665,1318497671,1318497687,6,16
8214,1318497724,1318497731,1318497743,7,12
8200,1318497653,1318497656,1318497724,3,68
8207,1318497683,1318497686,1318497729,3,43
8213,1318497712,1318497716,1318497833,4,117
8202,1318497661,1318497671,1318497880,10,209
8218,1318497769,1318497776,1318497884,7,108
8201,1318497656,1318497671,1318497883,15,212
8223,1318497792,1318497806,1318497958,14,152
8224,1318497794,1318497806,1318497958,12,152
8219,1318497777,1318497791,1318498089,14,298
8222,1318497790,1318497791,1318498082,1,291
8205,1318497679,1318497686,1318498141,7,455
8206,1318497681,1318497686,1318498130,5,444
8217,1318497766,1318497776,1318498205,10,429
8215,1318497756,1318497761,1318498379,5,618
8226,1318499561,1318499576,1318499580,15,4
8227,1318500325,1318500326,1318500532,1,206
8212,1318497707,1318497716,1318501630,9,3914
8221,1318497789,1318497791,1318501880,2,4089
8220,1318497787,1318497791,1318502021,4,4230
8209,1318497700,1318497701,1318502866,1,5165
8211,1318497704,1318497716,1318504028,12,6312
8210,1318497702,1318497716,1318504789,14,7073
8192,1318492101,1318492107,1318505373,6,13266
8216,1318497760,1318497761,1318507528,1,9767
8232,1318507973,1318507976,1318507995,3,19
8230,1318507968,1318507976,1318507990,8,14
8231,1318507970,1318507976,1318507994,6,18
8228,1318507961,1318507976,1318507985,15,9
8229,1318507965,1318507976,1318507985,11,9
8236,1318508403,1318508411,1318508439,8,28
8237,1318508407,1318508411,1318508432,4,21
8238,1318508439,1318508441,1318508477,2,36
8235,1318508401,1318508411,1318508455,10,44
8234,1318508399,1318508411,1318508504,12,93
8233,1318508396,1318508411,1318508535,15,124
8246,1318508474,1318508486,1318508566,12,80
8245,1318508472,1318508486,1318508580,14,94
8247,1318508475,1318508486,1318508572,11,86
8248,1318508484,1318508486,1318508602,2,116
8243,1318508467,1318508471,1318508811,4,340
8244,1318508470,1318508471,1318508809,1,338
8239,1318508442,1318508456,1318509042,14,586
8240,1318508443,1318508456,1318509231,13,775
8253,1318509434,1318509446,1318509452,12,6
8251,1318508493,1318508501,1318515931,8,7430
8254,1318516453,1318516466,1318516478,13,12
8256,1318516607,1318516616,1318516620,9,4
8252,1318508497,1318508501,1318517313,4,8812
8249,1318508488,1318508501,1318517733,13,9232
8261,1318518659,1318518671,1318518675,12,4
8260,1318518616,1318518626,1318518631,10,5
8262,1318518690,1318518701,1318518705,11,4
8263,1318518942,1318518956,1318518960,14,4
8241,1318508445,1318508456,1318522152,11,13696
8250,1318508490,1318508501,1318522353,11,13852
8242,1318508448,1318508456,1318524921,8,16465
8025,1317381400,1317381415,1318581456,15,1200041
8264,1318582334,1318582346,1318582350,12,4
8265,1318582573,1318582586,1318582591,13,5
8266,1318582575,1318582586,1318582597,11,11
8267,1318582576,1318582586,1318582597,10,11
8268,1318582578,1318582586,1318582605,8,19
8269,1318582580,1318582586,1318582603,6,17
8270,1318582792,1318582796,1318582801,4,5
8271,1318582796,1318582811,1318582817,15,6
8272,1318582798,1318582811,1318582818,13,7
8273,1318582799,1318582811,1318582842,12,31
8274,1318582801,1318582811,1318582827,10,16
8275,1318582812,1318582826,1318582831,14,5
8276,1318588513,1318588526,1318591094,13,2568
8277,1318592257,1318592261,1318592606,4,345
8279,1318592976,1318592981,1318592988,5,7
8280,1318592979,1318592981,1318593001,2,20
8281,1318592980,1318592981,1318593001,1,20
8282,1318592982,1318592996,1318593048,14,52
8283,1318592984,1318592996,1318593075,12,79
8284,1318598583,1318598591,1318598599,8,8
8285,1318598584,1318598591,1318598609,7,18
8286,1318598586,1318598591,1318598622,5,31
8287,1318598588,1318598591,1318598767,3,176
8288,1318598590,1318598591,1318598776,1,185
8294,1318602890,1318602896,1318602915,6,19
8295,1318602893,1318602896,1318602945,3,49
8297,1318602912,1318602926,1318602948,14,22
8298,1318602914,1318602926,1318603089,12,163
8289,1318602851,1318602866,1318602934,15,68
8299,1318602915,1318602926,1318603084,11,158
8291,1318602857,1318602866,1318603291,9,425
8290,1318602854,1318602866,1318603152,12,286
8301,1318602940,1318602941,1318603312,1,371
8296,1318602895,1318602896,1318603780,1,884
8088,1317644049,1317644051,1318604553,2,960502
8300,1318602938,1318602941,1318606297,3,3356
8292,1318602859,1318602866,1318611594,7,8728
8293,1318602862,1318602866,1318613760,4,10894
8257,1318518483,1318518495,1318678404,12,159909
8302,1318688977,1318688981,1318706548,4,17567
8026,1317381409,1317381415,1318745637,6,1364222
8115,1317812117,1317812126,1318763207,9,951081
7977,1317132198,1317132205,1318790831,7,1658626
8307,1318767382,1318767386,1318838545,4,71159
8308,1318838571,1318838577,1318840098,6,1521
8309,1318840227,1318840241,1318841511,14,1270
8310,1318841502,1318841516,1318841939,14,423
8313,1318856362,1318856366,1318856386,4,20
8314,1318856364,1318856366,1318856389,2,23
8311,1318856358,1318856366,1318856372,8,6
8312,1318856360,1318856366,1318856373,6,7
8315,1318856368,1318856381,1318856396,13,15
8316,1318859100,1318859111,1318859116,11,5
8317,1318860080,1318860086,1318860088,6,2
8318,1318860083,1318860086,1318860090,3,4
8319,1318860564,1318860566,1318860570,2,4
8322,1318862135,1318862141,1318862167,6,26
8323,1318862138,1318862141,1318862155,3,14
8320,1318862128,1318862141,1318862144,13,3
8321,1318862134,1318862141,1318862149,7,8
8324,1318862420,1318862427,1318862432,7,5
8325,1318864000,1318864001,1318864006,1,5
8326,1318864107,1318864121,1318864138,14,17
8327,1318864418,1318864422,1318864427,4,5
8328,1318924337,1318924347,1318924972,10,625
8330,1318925105,1318925111,1318925114,6,3
8329,1318924384,1318924391,1318925316,7,925
8334,1318927018,1318927031,1318927034,13,3
8335,1318927108,1318927121,1318927125,13,4
8332,1318925726,1318925741,1318928115,15,2374
8333,1318925734,1318925741,1318928961,7,3220
8340,1318931095,1318931096,1318931108,1,12
8336,1318931088,1318931096,1318931100,8,4
8337,1318931090,1318931096,1318931101,6,5
8338,1318931091,1318931096,1318931102,5,6
8339,1318931093,1318931096,1318931103,3,7
8303,1318689297,1318706576,1318931970,17279,225394
8341,1318932336,1318932341,1318932345,5,4
8344,1318933391,1318933406,1318933410,15,4
8345,1318933398,1318933406,1318933414,8,8
8346,1318934306,1318934321,1318934325,15,4
8347,1318935649,1318935656,1318935661,7,5
8348,1318935780,1318935791,1318935796,11,5
8349,1318938532,1318938536,1318938540,4,4
8350,1318939031,1318939046,1318939050,15,4
8351,1318939268,1318939271,1318939276,3,5
8352,1318939412,1318939421,1318939424,9,3
8353,1318941683,1318941686,1318941690,3,4
8354,1318944035,1318944041,1318944045,6,4
8355,1318944779,1318944791,1318944796,12,5
8356,1318945728,1318945736,1318945739,8,3
8357,1318946319,1318946321,1318946326,2,5
8358,1318946409,1318946411,1318946415,2,4
8361,1318946654,1318946666,1318946669,12,3
8359,1318946639,1318946651,1318946833,12,182
8362,1318947186,1318947191,1318948939,5,1748
8364,1318949668,1318949681,1318949685,13,4
8365,1318949703,1318949711,1318949715,8,4
8366,1318950990,1318951001,1318951005,11,4
8367,1318952061,1318952066,1318952070,5,4
8363,1318949467,1318949471,1318966528,4,17057
7994,1317205406,1317230560,1318995681,25154,1765121
8374,1319007347,1319007356,1319007360,9,4
8373,1319007336,1319007341,1319007348,5,7
8375,1319007390,1319007401,1319007406,11,5
8376,1319007392,1319007401,1319007406,9,5
8377,1319009457,1319009471,1319009475,14,4
8378,1319009673,1319009681,1319009686,8,5
8381,1319011681,1319011691,1319011695,10,4
8382,1319011766,1319011781,1319011785,15,4
8383,1319012511,1319012516,1319012522,5,6
8384,1319012516,1319012531,1319012536,15,5
8385,1319012738,1319012741,1319012746,3,5
8386,1319013381,1319013386,1319013392,5,6
8387,1319013395,1319013401,1319013407,6,6
8388,1319013605,1319013611,1319013623,6,12
8389,1319013608,1319013611,1319013623,3,12
8390,1319013670,1319013671,1319013680,1,9
8391,1319013673,1319013686,1319013696,13,10
8379,1319010020,1319010026,1319014638,6,4612
8392,1319014641,1319014646,1319014655,5,9
8393,1319014650,1319014661,1319014671,11,10
8394,1319014811,1319014826,1319014834,15,8
8401,1319022372,1319022386,1319022386,14,0
8402,1319022493,1319022506,1319022768,13,262
8403,1319022531,1319022536,1319022807,5,271
8406,1319028633,1319028641,1319028647,8,6
8407,1319029361,1319029376,1319029381,15,5
8408,1319029450,1319029451,1319029456,1,5
8409,1319029459,1319029466,1319029471,7,5
8410,1319029591,1319029601,1319029606,10,5
8411,1319029593,1319029601,1319029606,8,5
8412,1319029595,1319029601,1319029606,6,5
8413,1319030490,1319030501,1319030505,11,4
8414,1319031302,1319031311,1319031315,9,4
8415,1319031582,1319031596,1319031601,14,5
8416,1319031810,1319031821,1319031826,11,5
8419,1319032734,1319032736,1319032764,2,28
8420,1319032735,1319032736,1319032775,1,39
8417,1319032729,1319032736,1319032745,7,9
8418,1319032732,1319032736,1319032745,4,9
8421,1319034996,1319035001,1319035007,5,6
8422,1319035472,1319035481,1319035486,9,5
8423,1319036651,1319036666,1319036680,15,14
8424,1319036967,1319036981,1319036989,14,8
8425,1319037456,1319037461,1319037467,5,6
8399,1319021535,1319021546,1319041647,11,20101
8400,1319021538,1319021546,1319060531,8,38985
8398,1319021532,1319021546,1319064744,14,43198
7962,1317023294,1317023305,1319080265,11,2056960
8428,1319092456,1319092466,1319092471,10,5
8431,1319096446,1319096456,1319096459,10,3
8432,1319096451,1319096456,1319096460,5,4
8433,1319096473,1319096486,1319096489,13,3
8434,1319096529,1319096531,1319096535,2,4
8435,1319096710,1319096711,1319096715,1,4
8436,1319096760,1319096771,1319096774,11,3
8437,1319096801,1319096817,1319096822,16,5
8439,1319096856,1319096861,1319096863,5,2
8438,1319096834,1319096846,1319096850,12,4
8440,1319096886,1319096891,1319096895,5,4
8441,1319096980,1319096981,1319096984,1,3
8442,1319097061,1319097071,1319097075,10,4
8443,1319097129,1319097131,1319097135,2,4
8444,1319097212,1319097221,1319097225,9,4
8446,1319097330,1319097341,1319097345,11,4
8445,1319097298,1319097311,1319097315,13,4
8447,1319098244,1319098256,1319098263,12,7
8448,1319098560,1319098571,1319098578,11,7
8449,1319099392,1319099396,1319099409,4,13
8450,1319099865,1319099876,1319099891,11,15
8452,1319100072,1319100086,1319100103,14,17
8453,1319100184,1319100191,1319100207,7,16
8454,1319102109,1319102111,1319102117,2,6
8455,1319102808,1319102816,1319102830,8,14
8456,1319103010,1319103011,1319103025,1,14
8457,1319104390,1319104391,1319104413,1,22
8458,1319104606,1319104616,1319104622,10,6
8459,1319104621,1319104631,1319104677,10,46
8460,1319104860,1319104871,1319104871,11,0
8461,1319105390,1319105397,1319105398,7,1
8464,1319106134,1319106146,1319106146,12,0
8465,1319106221,1319106236,1319106236,15,0
8466,1319106365,1319106371,1319106371,6,0
8467,1319106450,1319106461,1319106658,11,197
8468,1319107154,1319107166,1319107173,12,7
8469,1319107159,1319107166,1319107173,7,7
8470,1319107455,1319107466,1319107484,11,18
8471,1319107716,1319107721,1319107726,5,5
8472,1319107806,1319107811,1319107827,5,16
8473,1319107959,1319107961,1319107978,2,17
8475,1319108029,1319108036,1319108043,7,7
8474,1319107965,1319107976,1319108116,11,140
8476,1319108123,1319108126,1319108132,3,6
8477,1319108219,1319108232,1319109627,13,1395
8478,1319109440,1319109446,1319109636,6,190
8479,1319109742,1319109746,1319110682,4,936
8480,1319111489,1319111501,1319111501,12,0
8481,1319111785,1319111786,1319111786,1,0
8482,1319112011,1319112026,1319112213,15,187
8483,1319112822,1319112836,1319112892,14,56
8484,1319113156,1319113166,1319113166,10,0
8485,1319113362,1319113377,1319113378,15,1
8487,1319114238,1319114246,1319114252,8,6
8488,1319114325,1319114336,1319114341,11,5
8489,1319114884,1319114891,1319114895,7,4
8490,1319114949,1319114951,1319114957,2,6
8491,1319115069,1319115071,1319115078,2,7
8492,1319115267,1319115281,1319115284,14,3
8493,1319115371,1319115386,1319115397,15,11
8494,1319116098,1319116106,1319116147,8,41
8495,1319134085,1319134091,1319134092,6,1
8496,1319134361,1319134376,1319134410,15,34
8497,1319134666,1319134676,1319134710,10,34
8404,1319023341,1319023346,1319138203,5,114857
8430,1319093140,1319093141,1319152631,1,59490
8405,1319023350,1319023361,1319168532,11,145171
8371,1319004939,1319004941,1319184607,2,179666
8426,1319042589,1319042591,1319191026,2,148435
8498,1319205854,1319205866,1319205878,12,12
8499,1319206109,1319206121,1319206137,12,16
8500,1319206451,1319206466,1319206481,15,15
8501,1319206792,1319206796,1319206820,4,24
8502,1319207053,1319207066,1319207089,13,23
8503,1319207234,1319207246,1319207275,12,29
8504,1319207828,1319207831,1319207835,3,4
8505,1319207855,1319207861,1319207865,6,4
8506,1319208264,1319208266,1319208294,2,28
8507,1319209205,1319209211,1319209221,6,10
8510,1319209934,1319209946,1319209965,12,19
8509,1319209922,1319209931,1319209943,9,12
8508,1319209906,1319209916,1319209924,10,8
8511,1319209966,1319209976,1319210001,10,25
8512,1319209981,1319209991,1319210026,10,35
8513,1319210783,1319210786,1319210797,3,11
8514,1319210815,1319210816,1319210833,1,17
8516,1319210913,1319210921,1319210954,8,33
8515,1319210868,1319210876,1319210923,8,47
8517,1319211242,1319211251,1319211251,9,0
8518,1319211733,1319211747,1319211747,14,0
8519,1319211921,1319211926,1319211926,5,0
8520,1319212120,1319212121,1319212121,1,0
8521,1319212207,1319212211,1319212211,4,0
8522,1319212342,1319212346,1319212346,4,0
8523,1319212971,1319212976,1319212976,5,0
8368,1319004837,1319004852,1319213206,15,208354
8524,1319214151,1319214161,1319214161,10,0
8525,1319214642,1319214656,1319214657,14,1
8085,1317639765,1317639777,1319214669,12,1574892
8526,1319214844,1319214851,1319214851,7,0
8527,1319214947,1319214956,1319214988,9,32
8528,1319215099,1319215106,1319215107,7,1
8529,1319215199,1319215211,1319215212,12,1
8530,1319215361,1319215376,1319215377,15,1
8531,1319215508,1319215512,1319215513,4,1
8532,1319215557,1319215571,1319215572,14,1
8533,1319215608,1319215616,1319215622,8,6
8534,1319215707,1319215721,1319215722,14,1
8535,1319215843,1319215856,1319215857,13,1
8536,1319216222,1319216231,1319216232,9,1
8537,1319216409,1319216411,1319216412,2,1
8538,1319216469,1319216471,1319216472,2,1
8539,1319216651,1319216666,1319216912,15,246
8429,1319093010,1319093021,1319230824,11,137803
8540,1319276280,1319276291,1319276303,11,12
8073,1317625013,1317625526,1319295926,513,1670400
8331,1318925678,1318925681,1319317759,3,392078
8541,1319361892,1319361896,1319361953,4,57
8542,1319362104,1319362106,1319362106,2,0
8543,1319362226,1319362241,1319362259,15,18
8544,1319362786,1319362796,1319362966,10,170
8278,1318592617,1318592622,1319365968,5,773346
8545,1319365961,1319365991,1319366007,30,16
8546,1319366175,1319366186,1319366195,11,9
8547,1319366303,1319366306,1319366322,3,16
8548,1319366368,1319366381,1319366394,13,13
8551,1319379449,1319379461,1319379748,12,287
8553,1319379513,1319379521,1319379819,8,298
8552,1319379491,1319379506,1319380074,15,568
8549,1319366409,1319366411,1319385763,2,19352
8154,1318323877,1318323881,1319406245,4,1082364
8550,1319367062,1319367071,1319410124,9,43053
8559,1319442323,1319442326,1319442329,3,3
8556,1319442289,1319442296,1319442319,7,23
8557,1319442293,1319442296,1319442301,3,5
8558,1319442302,1319442311,1319442338,9,27
8561,1319442348,1319442356,1319442359,8,3
8560,1319442335,1319442341,1319442394,6,53
8563,1319442373,1319442386,1319442390,13,4
8565,1319442435,1319442446,1319442449,11,3
8562,1319442363,1319442371,1319442508,8,137
8566,1319442461,1319442476,1319442481,15,5
8567,1319442521,1319442536,1319442548,15,12
8564,1319442392,1319442401,1319442614,9,213
8568,1319442561,1319442566,1319442591,5,25
8569,1319442593,1319442597,1319442644,4,47
8570,1319442645,1319442656,1319442797,11,141
8571,1319442726,1319442731,1319442952,5,221
8572,1319442953,1319442956,1319442982,3,26
8573,1319446258,1319446271,1319446347,13,76
8574,1319447177,1319447186,1319447191,9,5
8575,1319447513,1319447516,1319447519,3,3
8576,1319448209,1319448221,1319448222,12,1
8578,1319448843,1319448851,1319448925,8,74
8577,1319448516,1319448522,1319448960,6,438
8579,1319450160,1319450171,1319450176,11,5
8580,1319450528,1319450531,1319450537,3,6
8581,1319451788,1319451791,1319451803,3,12
8582,1319452520,1319452526,1319452527,6,1
8583,1319452605,1319452616,1319452622,11,6
8584,1319452750,1319452751,1319452995,1,244
8585,1319453440,1319453441,1319453879,1,438
8586,1319453908,1319453908,1319454015,0,107
8587,1319454250,1319454250,1319454332,0,82
8588,1319454665,1319454670,1319454675,5,5
8589,1319455570,1319455585,1319455592,15,7
8590,1319456396,1319456397,1319456499,1,102
8591,1319456510,1319456516,1319456516,6,0
8555,1319379704,1319379716,1319456623,12,76907
8593,1319456600,1319456606,1319456613,6,7
8596,1319457103,1319457116,1319457120,13,4
8594,1319456937,1319456951,1319457199,14,248
8597,1319458305,1319458316,1319458317,11,1
8598,1319458431,1319458436,1319458441,5,5
8600,1319458517,1319458527,1319458558,10,31
8599,1319458456,1319458467,1319458566,11,99
8602,1319458673,1319458676,1319458682,3,6
8601,1319458643,1319458646,1319458942,3,296
8603,1319458943,1319458946,1319459375,3,429
8604,1319459498,1319459501,1319459528,3,27
8605,1319459831,1319459846,1319459853,15,7
8606,1319459929,1319459936,1319459942,7,6
8607,1319459961,1319459966,1319459974,5,8
8608,1319459992,1319459996,1319460005,4,9
8609,1319460159,1319460161,1319460168,2,7
8610,1319460204,1319460206,1319460224,2,18
8611,1319460217,1319460221,1319460227,4,6
8612,1319460311,1319460326,1319460343,15,17
8613,1319460562,1319460566,1319460575,4,9
8614,1319461203,1319461213,1319461245,10,32
8615,1319461277,1319461286,1319461319,9,33
8616,1319461406,1319461421,1319462337,15,916
8617,1319462329,1319462336,1319462770,7,434
8619,1319462863,1319462876,1319462883,13,7
8620,1319462872,1319462876,1319462879,4,3
8621,1319462880,1319462891,1319462901,11,10
8622,1319462884,1319462891,1319462894,7,3
8623,1319462889,1319462891,1319462907,2,16
8624,1319462892,1319462906,1319462911,14,5
8625,1319462897,1319462906,1319462930,9,24
8626,1319462901,1319462906,1319462909,5,3
8627,1319462910,1319462921,1319462949,11,28
8629,1319463069,1319463071,1319463077,2,6
8630,1319463107,1319463116,1319463131,9,15
8631,1319463147,1319463161,1319463175,14,14
8618,1319462377,1319462381,1319463302,4,921
8632,1319463250,1319463251,1319463291,1,40
8633,1319463253,1319463266,1319463309,13,43
8634,1319463448,1319463461,1319463478,13,17
8635,1319463772,1319463777,1319463808,5,31
8641,1319464000,1319464001,1319464018,1,17
8636,1319463966,1319463971,1319463993,5,22
8637,1319463968,1319463971,1319463993,3,22
8638,1319463970,1319463971,1319463994,1,23
8639,1319463972,1319463986,1319464022,14,36
8640,1319463974,1319463986,1319464035,12,49
8644,1319464167,1319464181,1319464208,14,27
8645,1319464169,1319464181,1319464205,12,24
8646,1319464172,1319464181,1319464216,9,35
8642,1319464164,1319464166,1319464175,2,9
8643,1319464165,1319464166,1319464175,1,9
8647,1319464240,1319464241,1319464258,1,17
8648,1319464724,1319464736,1319464774,12,38
8649,1319464726,1319464736,1319464783,10,47
8653,1319464829,1319464841,1319464872,12,31
8650,1319464728,1319464736,1319464894,8,158
8652,1319464731,1319464736,1319464986,5,250
8654,1319464886,1319464901,1319465024,15,123
8655,1319464888,1319464901,1319465024,13,123
8656,1319465020,1319465021,1319465040,1,19
8657,1319465023,1319465036,1319465069,13,33
8658,1319465025,1319465036,1319465111,11,75
8651,1319464730,1319464736,1319465191,6,455
8659,1319465026,1319465036,1319465247,10,211
8660,1319465028,1319465036,1319465248,8,212
8661,1319465290,1319465291,1319465383,1,92
8669,1319465423,1319465426,1319465427,3,1
8664,1319465399,1319465411,1319465431,12,20
8665,1319465402,1319465411,1319465441,9,30
8662,1319465293,1319465306,1319465493,13,187
8666,1319465404,1319465411,1319465493,7,82
8670,1319465520,1319465532,1319465533,12,1
8668,1319465410,1319465411,1319465534,1,123
8667,1319465406,1319465411,1319465523,5,112
8369,1319004842,1319295972,1319465621,291130,169649
8663,1319465295,1319465306,1319465637,11,331
8671,1319465985,1319465996,1319466025,11,29
8672,1319466192,1319466206,1319466236,14,30
8677,1319466271,1319466281,1319466297,10,16
8678,1319466330,1319466341,1319466371,11,30
8679,1319466399,1319466401,1319466421,2,20
8680,1319466668,1319466671,1319466701,3,30
8681,1319466792,1319466806,1319466827,14,21
8682,1319466879,1319466881,1319466897,2,16
8683,1319467437,1319467452,1319467482,15,30
8684,1319467793,1319467796,1319467812,3,16
8685,1319468086,1319468096,1319468113,10,17
8687,1319468204,1319468216,1319468238,12,22
8686,1319468123,1319468126,1319468177,3,51
8688,1319468305,1319468306,1319468401,1,95
8689,1319468383,1319468396,1319468422,13,26
8690,1319468499,1319468501,1319468523,2,22
8691,1319468585,1319468591,1319468633,6,42
8692,1319468603,1319468606,1319468662,3,56
8693,1319468624,1319468636,1319468735,12,99
8694,1319468641,1319468651,1319468783,10,132
8695,1319468793,1319468801,1319469278,8,477
8696,1319469455,1319469462,1319469523,7,61
8697,1319470099,1319470106,1319470107,7,1
8698,1319470346,1319470361,1319470819,15,458
8699,1319470372,1319470376,1319470834,4,458
8700,1319470520,1319470526,1319470953,6,427
8701,1319471009,1319471021,1319471051,12,30
8427,1319042607,1319042621,1319472973,14,430352
8704,1319473881,1319473886,1319473922,5,36
8703,1319473807,1319473811,1319473922,4,111
8702,1319473723,1319473736,1319473922,13,186
8705,1319473982,1319473991,1319474277,9,286
8707,1319474074,1319474081,1319474400,7,319
8706,1319474021,1319474036,1319474882,15,846
8554,1319379661,1319379671,1319475250,10,95579
8595,1319457026,1319457041,1319478376,15,21335
8165,1318402526,1318402541,1319480460,15,1077919
8710,1319484215,1319484221,1319487863,6,3642
8708,1319484159,1319484161,1319488649,2,4488
8372,1319004943,1319317796,1319492332,312853,174536
8709,1319484189,1319484192,1319504847,3,20655
8711,1319527576,1319527586,1319527638,10,52
8714,1319529541,1319529551,1319529680,10,129
8715,1319530406,1319530421,1319530422,15,1
8716,1319530474,1319530481,1319530481,7,0
8717,1319530550,1319530556,1319530557,6,1
8719,1319530898,1319530901,1319530924,3,23
8721,1319531248,1319531262,1319531511,14,249
8722,1319532176,1319532191,1319532191,15,0
8724,1319532294,1319532297,1319532320,3,23
8723,1319532246,1319532251,1319532534,5,283
8725,1319532512,1319532521,1319532545,9,24
8712,1319527926,1319527931,1319532717,5,4786
8726,1319532981,1319532986,1319533109,5,123
8730,1319533869,1319533871,1319533929,2,58
8731,1319533997,1319534007,1319534270,10,263
8713,1319528218,1319528231,1319534998,13,6767
8732,1319534961,1319534966,1319534998,5,32
8733,1319535043,1319535056,1319535321,13,265
8727,1319532986,1319533001,1319535941,15,2940
8734,1319535726,1319535731,1319536165,5,434
8735,1319536273,1319536286,1319536530,13,244
8736,1319536811,1319536826,1319537024,15,198
8728,1319532990,1319533001,1319537127,11,4126
8729,1319532994,1319533001,1319537524,7,4523
8741,1319538907,1319538911,1319539057,4,146
8743,1319539610,1319539616,1319539665,6,49
8742,1319539535,1319539541,1319540001,6,460
8744,1319540081,1319540097,1319540380,16,283
8745,1319540513,1319540517,1319540624,4,107
8746,1319542866,1319542871,1319542905,5,34
8141,1318064945,1318064951,1319543106,6,1478155
8750,1319543997,1319544011,1319544081,14,70
8751,1319544268,1319544281,1319544472,13,191
8747,1319542952,1319542961,1319544583,9,1622
8752,1319544675,1319544686,1319544687,11,1
8753,1319544706,1319544716,1319544717,10,1
8754,1319544891,1319544896,1319545141,5,245
8755,1319545299,1319545301,1319545542,2,241
8756,1319545563,1319545571,1319545762,8,191
8757,1319545807,1319545812,1319546186,5,374
8758,1319546218,1319546231,1319546265,13,34
8759,1319546425,1319546426,1319546428,1,2
8760,1319546462,1319546471,1319546627,9,156
8761,1319546736,1319546741,1319546781,5,40
8762,1319546973,1319546981,1319547036,8,55
8718,1319530624,1319530631,1319547768,7,17137
8749,1319543174,1319543186,1319547779,12,4593
8764,1319547909,1319547911,1319547912,2,1
8765,1319548061,1319548076,1319548133,15,57
8766,1319548278,1319548286,1319548342,8,56
8768,1319549035,1319549036,1319549043,1,7
8767,1319548372,1319548376,1319549180,4,804
8763,1319547203,1319547206,1319549180,3,1974
8769,1319549255,1319549261,1319549268,6,7
8771,1319553612,1319553626,1319553809,14,183
8772,1319553902,1319553911,1319553977,9,66
8773,1319554560,1319554571,1319554651,11,80
8774,1319554759,1319554766,1319555214,7,448
8775,1319555304,1319555306,1319555603,2,297
8777,1319556052,1319556056,1319556130,4,74
8778,1319556173,1319556176,1319556247,3,71
8779,1319556429,1319556431,1319556613,2,182
8780,1319556673,1319556686,1319560369,13,3683
8748,1319543042,1319543051,1319564226,9,21175
8770,1319549397,1319549412,1319569927,15,20515
8673,1319466218,1319466221,1319578305,3,112084
8156,1318323914,1318323926,1319592636,12,1268710
8776,1319555739,1319555741,1319594350,2,38609
8781,1319609897,1319609906,1319613319,9,3413
8782,1319610409,1319610416,1319613633,7,3217
8783,1319613546,1319613551,1319613986,5,435
8784,1319614550,1319614556,1319614803,6,247
8786,1319616319,1319616326,1319616762,7,436
8787,1319616997,1319617001,1319617403,4,402
8788,1319617569,1319617571,1319617576,2,5
8789,1319617597,1319617601,1319617678,4,77
8790,1319617803,1319617811,1319617882,8,71
8674,1319466221,1319466236,1319622875,15,156639
8794,1319624126,1319624141,1319624235,15,94
8793,1319619584,1319619596,1319626294,12,6698
8795,1319626110,1319626121,1319626333,11,212
8796,1319626426,1319626436,1319626549,10,113
8797,1319626704,1319626707,1319626709,3,2
8798,1319626835,1319626842,1319626852,7,10
8799,1319627191,1319627201,1319627334,10,133
8800,1319628580,1319628581,1319628596,1,15
8801,1319628593,1319628596,1319628739,3,143
8802,1319629048,1319629061,1319629205,13,144
8803,1319629979,1319629991,1319630002,12,11
8804,1319631126,1319631132,1319631144,6,12
8785,1319615762,1319615771,1319631331,9,15560
8791,1319618662,1319618666,1319631612,4,12946
8805,1319631573,1319631581,1319631615,8,34
8806,1319632737,1319632751,1319632755,14,4
8807,1319632888,1319632901,1319632916,13,15
8808,1319633024,1319633036,1319633053,12,17
8809,1319633252,1319633261,1319633274,9,13
8810,1319633362,1319633367,1319633383,5,16
8811,1319633745,1319633756,1319633758,11,2
8812,1319633867,1319633876,1319633891,9,15
8792,1319618708,1319618711,1319634239,3,15528
8813,1319634704,1319634716,1319634728,12,12
8738,1319538026,1319538041,1319634818,15,96777
8814,1319635086,1319635091,1319635108,5,17
8815,1319635271,1319635286,1319635286,15,0
8816,1319635354,1319635361,1319635362,7,1
8817,1319635597,1319635601,1319635601,4,0
8818,1319635658,1319635661,1319635662,3,1
8819,1319636950,1319636951,1319636951,1,0
8820,1319636983,1319636996,1319636997,13,1
8824,1319640784,1319640791,1319640886,7,95
8825,1319640927,1319640942,1319641367,15,425
8826,1319641464,1319641466,1319641557,2,91
8827,1319641581,1319641586,1319641874,5,288
8828,1319641910,1319641916,1319642012,6,96
8830,1319642557,1319642561,1319642652,4,91
8831,1319642912,1319642921,1319643418,9,497
8832,1319643462,1319643476,1319645748,14,2272
8833,1319652284,1319652296,1319652371,12,75
8835,1319652615,1319652626,1319652706,11,80
8836,1319652767,1319652776,1319652857,9,81
8837,1319652887,1319652896,1319652991,9,95
8834,1319652407,1319652416,1319653099,9,683
8821,1319637079,1319637086,1319653108,7,16022
8838,1319653061,1319653077,1319653108,16,31
8839,1319653133,1319653136,1319653385,3,249
8841,1319655434,1319655446,1319655530,12,84
8840,1319653191,1319653197,1319657327,6,4130
8675,1319466223,1319466236,1319697404,13,231168
8823,1319637299,1319637311,1319700699,12,63388
8843,1319702000,1319702006,1319702301,6,295
8844,1319702328,1319702336,1319702408,8,72
8845,1319702450,1319702456,1319702685,6,229
8822,1319637273,1319637281,1319706991,8,69710
8846,1319709110,1319709116,1319709118,6,2
8676,1319466226,1319466236,1319721130,10,254894
8850,1319719885,1319719886,1319721228,1,1342
8852,1319721329,1319721341,1319721342,12,1
8853,1319721334,1319721341,1319721342,7,1
8851,1319721326,1319721341,1319721342,15,1
8858,1319725705,1319725706,1319725714,1,8
8859,1319726440,1319726441,1319726446,1,5
8860,1319728207,1319728211,1319728217,4,6
8861,1319728326,1319728331,1319728336,5,5
8862,1319728420,1319728421,1319728426,1,5
8863,1319728998,1319729006,1319729011,8,5
8854,1319721520,1319721521,1319738618,1,17097
8855,1319721523,1319721536,1319754810,13,33274
8865,1319738779,1319738786,1319765967,7,27181
8864,1319738659,1319738666,1319768816,7,30150
8856,1319721526,1319721536,1319773668,10,52132
8829,1319642059,1319642066,1319775794,7,133728
8842,1319655621,1319655626,1319789867,5,134241
8849,1319711232,1319711246,1319790339,14,79093
8868,1319792077,1319792081,1319792087,4,6
8869,1319792115,1319792126,1319793172,11,1046
8870,1319793198,1319793206,1319793376,8,170
8306,1318689500,1318689510,1319795422,10,1105912
8380,1319010656,1319010671,1319798454,15,787783
8871,1319793395,1319793401,1319799101,6,5700
8879,1319799382,1319799386,1319799653,4,267
8881,1319799389,1319799401,1319799654,12,253
8880,1319799385,1319799386,1319799658,1,272
8878,1319799373,1319799386,1319800604,13,1218
8867,1319790668,1319790671,1319804333,3,13662
8882,1319799399,1319799401,1319805363,2,5962
8884,1319805664,1319805671,1319805671,7,0
8885,1319805716,1319805731,1319805731,15,0
8891,1319806012,1319806016,1319806146,4,130
8889,1319806005,1319806016,1319806146,11,130
8886,1319805837,1319805851,1319806299,14,448
8893,1319806223,1319806226,1319806451,3,225
8898,1319806434,1319806436,1319806436,2,0
8896,1319806418,1319806421,1319806505,3,84
8897,1319806421,1319806436,1319806520,15,84
8894,1319806226,1319806241,1319806616,15,375
8887,1319805843,1319805851,1319806989,8,1138
8902,1319807132,1319807141,1319807374,9,233
8899,1319806465,1319806496,1319807502,31,1006
8907,1319807872,1319807876,1319808004,4,128
8906,1319807869,1319807876,1319808004,7,128
8900,1319806500,1319806526,1319808276,26,1750
8904,1319807764,1319807771,1319810142,7,2371
8910,1319813967,1319813981,1319814121,14,140
8911,1319813969,1319813981,1319814122,12,141
8892,1319806077,1319806091,1319815092,14,9001
8909,1319811596,1319811611,1319820784,15,9173
8903,1319807349,1319807351,1319820812,2,13461
8912,1319813973,1319813981,1319824350,8,10369
8857,1319721530,1319721536,1319833735,6,112199
8890,1319806009,1319806016,1319834123,7,28107
8877,1319799366,1319799375,1319835026,9,35651
8908,1319811083,1319811086,1319837102,3,26016
8255,1318516600,1318516601,1319859674,1,1343073
8905,1319807857,1319807861,1319869858,4,61997
8895,1319806229,1319806241,1319885987,12,79746
8848,1319710052,1319710061,1319900230,9,190169
8888,1319805907,1319805911,1319909636,4,103725
8873,1319795315,1319795321,1319913238,6,117917
8918,1319900887,1319910746,1319919832,9859,9086
7931,1316480735,1316480740,1319956274,5,3475534
8866,1319790485,1319790492,1319967559,7,177067
8922,1319967818,1319967821,1319967946,3,125
8923,1319967825,1319967836,1319967958,11,122
8924,1319968958,1319968961,1319970401,3,1440
8929,1319970479,1319970491,1319970589,12,98
8930,1319970483,1319970491,1319970591,8,100
8928,1319969001,1319969006,1319970680,5,1674
8932,1319970571,1319970581,1319970759,10,178
8933,1319970573,1319970581,1319970759,8,178
8931,1319970485,1319970491,1319970877,6,386
8926,1319968972,1319968976,1319971130,4,2154
8921,1319967813,1319967821,1319974285,8,6464
8934,1319970576,1319970626,1319975280,50,4654
8939,1319981589,1319981591,1319981801,2,210
8938,1319981586,1319981591,1319981945,5,354
8936,1319981489,1319981501,1319981974,12,473
8937,1319981493,1319981501,1319981973,8,472
8942,1319981709,1319981831,1319982417,122,586
8943,1319981713,1319981966,1319982929,253,963
8925,1319968967,1319968976,1319983353,9,14377
8913,1319815087,1319859702,1319985526,44615,125824
8927,1319968998,1319969006,1319985880,8,16874
8945,1319985106,1319985116,1319989797,10,4681
8946,1319985109,1319985116,1319989851,7,4735
8916,1319900374,1319900381,1319991133,7,90752
8940,1319981593,1319981606,1319993933,13,12327
8917,1319900743,1319900756,1320002778,13,102022
8941,1319981696,1319981711,1320022360,15,40649
8883,1319802952,1319802956,1320026739,4,223783
8872,1319795277,1319795292,1320042941,15,247649
8947,1320049536,1320049541,1320049551,5,10
8948,1320049641,1320049646,1320049651,5,5
8914,1319815427,1319900261,1320049716,84834,149455
8949,1320049728,1320049736,1320049759,8,23
8950,1320049935,1320049949,1320050022,14,73
8951,1320050002,1320050006,1320050031,4,25
8952,1320050071,1320050081,1320050090,10,9
8953,1320050152,1320050156,1320050163,4,7
8955,1320050249,1320050261,1320050262,12,1
8954,1320050203,1320050216,1320050285,13,69
8959,1320050470,1320050471,1320050474,1,3
8957,1320050386,1320050396,1320050479,10,83
8958,1320050454,1320050456,1320050563,2,107
8960,1320050506,1320050516,1320050603,10,87
8961,1320050614,1320050621,1320050700,7,79
8964,1320050733,1320050741,1320050743,8,2
8962,1320050665,1320050666,1320050748,1,82
8963,1320050702,1320050711,1320050811,9,100
8967,1320050839,1320050846,1320050904,7,58
8965,1320050749,1320050756,1320050926,7,170
8966,1320050800,1320050801,1320050915,1,114
8968,1320051002,1320051011,1320051013,9,2
8969,1320051877,1320051882,1320051884,5,2
8970,1320051975,1320051986,1320051988,11,2
8971,1320053284,1320053291,1320053293,7,2
8972,1320053831,1320053846,1320053848,15,2
8973,1320053862,1320053876,1320053877,14,1
8974,1320054066,1320054071,1320054073,5,2
8975,1320054453,1320054461,1320054470,8,9
8944,1319985103,1319985551,1320055863,448,70312
8976,1320055060,1320055061,1320056447,1,1386
8980,1320056663,1320056666,1320058286,3,1620
8981,1320061623,1320061631,1320062000,8,369
8982,1320062041,1320062051,1320062183,10,132
8984,1320062880,1320062891,1320062892,11,1
8985,1320062929,1320062936,1320063043,7,107
8983,1320062199,1320062202,1320063604,3,1402
8977,1320055894,1320055901,1320063840,7,7939
8999,1320065925,1320065938,1320066307,13,369
9001,1320066124,1320066132,1320066839,8,707
8992,1320065185,1320065186,1320066963,1,1777
8995,1320065617,1320065621,1320067090,4,1469
9002,1320067195,1320067196,1320067228,1,32
8991,1320065146,1320065157,1320067455,11,2298
8993,1320065250,1320065261,1320067741,11,2480
9003,1320067252,1320067256,1320067964,4,708
9004,1320068242,1320068246,1320068279,4,33
9005,1320068302,1320068306,1320068308,4,2
9006,1320068549,1320068562,1320068564,13,2
9007,1320068696,1320068711,1320068743,15,32
9008,1320068805,1320068816,1320068817,11,1
8956,1320050340,1320050351,1320069167,11,18816
9009,1320069538,1320069551,1320069552,13,1
8997,1320065625,1320065636,1320069563,11,3927
9011,1320070007,1320070016,1320070018,9,2
9010,1320070000,1320070001,1320070006,1,5
8990,1320065131,1320065141,1320070389,10,5248
9013,1320070557,1320070571,1320070573,14,2
9014,1320070703,1320070706,1320070711,3,5
9015,1320070747,1320070751,1320070754,4,3
9016,1320070877,1320070886,1320070887,9,1
9017,1320070942,1320070946,1320070954,4,8
9019,1320071032,1320071036,1320071047,4,11
9020,1320071118,1320071126,1320071141,8,15
9021,1320071187,1320071201,1320071202,14,1
9012,1320070520,1320070526,1320071238,6,712
9022,1320071436,1320071441,1320071442,5,1
9000,1320066082,1320067121,1320071852,1039,4731
9023,1320072084,1320072086,1320072091,2,5
9025,1320072194,1320072206,1320072207,12,1
9024,1320072123,1320072131,1320072359,8,228
9026,1320072382,1320072386,1320072513,4,127
9028,1320072635,1320072641,1320072641,6,0
9027,1320072499,1320072507,1320073075,8,568
9030,1320073382,1320073391,1320073765,9,374
9031,1320073917,1320073931,1320074121,14,190
9032,1320074166,1320074171,1320074171,5,0
8996,1320065622,1320065636,1320074186,14,8550
8920,1319964943,1319964958,1320074037,15,109079
9029,1320073104,1320073106,1320075667,2,2561
9033,1320075878,1320075882,1320075913,4,31
9035,1320078831,0,0,-1320078831,0
9036,1320079406,1320079421,1320079421,15,0
9037,1320079615,1320079616,1320079617,1,1
9038,1320079660,1320079661,1320079661,1,0
9039,1320080149,1320080156,1320080157,7,1
9040,1320080226,1320080231,1320080232,5,1
8994,1320065321,1320065338,1320082340,17,17002
8979,1320056403,1320056411,1320082775,8,26364
9034,1320075942,1320075956,1320088960,14,13004
8998,1320065628,1320066986,1320097764,1358,30778
8935,1319981481,1319981486,1320099724,5,118238
8989,1320065015,1320065021,1320115476,6,50455
8342,1318932873,1318932881,1320126113,8,1193232
8875,1319795501,1319795516,1320133146,15,337630
8463,1319105805,1319105816,1320134188,11,1028372
9044,1320135464,1320135476,1320135477,12,1
9045,1320135791,1320135812,1320135812,21,0
9046,1320136530,1320136541,1320136542,11,1
9047,1320136671,1320136676,1320136676,5,0
9048,1320136831,1320136841,1320136841,10,0
9049,1320137246,1320137261,1320137262,15,1
9050,1320137425,1320137426,1320137426,1,0
9052,1320138755,1320138761,1320138761,6,0
9053,1320140756,1320140771,1320140771,15,0
9054,1320140829,1320140831,1320140833,2,2
9056,1320143846,1320143846,1320143920,0,74
9057,1320144040,1320144040,1320144213,0,173
9058,1320144369,1320144369,1320144899,0,530
9059,1320144942,1320144954,1320144956,12,2
9041,1320132838,1320132851,1320145811,13,12960
9060,1320147181,1320147190,1320147193,9,3
9061,1320148086,1320148086,1320148349,0,263
9062,1320148351,1320148351,1320148398,0,47
9063,1320148399,1320148399,1320148528,0,129
9064,1320148548,1320148551,1320148554,3,3
9065,1320149658,1320149659,1320149660,1,1
9066,1320149788,1320149788,1320150435,0,647
9067,1320150628,1320150628,1320150674,0,46
9043,1320133430,1320133436,1320153334,6,19898
9068,1320150675,1320150675,1320158769,0,8094
9069,1320161038,1320161040,1320161043,2,3
9070,1320161894,1320161895,1320161898,1,3
8978,1320055928,1320055931,1320204522,3,148591
8396,1319020352,1319020361,1320212783,9,1192422
8876,1319798290,1319798291,1320219897,1,421606
9072,1320222856,1320222870,1320224091,14,1221
9071,1320222854,1320222855,1320224103,1,1248
9075,1320226155,1320226170,1320226171,15,1
9076,1320231181,1320231195,1320231196,14,1
9077,1320231577,1320231585,1320231586,8,1
9078,1320231802,1320231810,1320231812,8,2
9079,1320232014,1320232020,1320232021,6,1
9080,1320232101,1320232125,1320232126,24,1
9081,1320232407,1320232410,1320232411,3,1
9082,1320232463,1320232470,1320232477,7,7
9083,1320232569,1320232575,1320233122,6,547
9084,1320233169,1320233175,1320233176,6,1
9085,1320233181,1320233190,1320233629,9,439
9086,1320234394,1320234405,1320234614,11,209
9087,1320238841,1320238845,1320239009,4,164
9088,1320239505,1320239520,1320239689,15,169
9089,1320239969,1320239971,1320239973,2,2
9042,1320133087,1320133091,1320239494,4,106403
8988,1320064864,1320064871,1320240894,7,176023
8462,1319105801,1319105816,1320287196,15,1181380
9092,1320304960,1320304965,1320305428,5,463
9094,1320305319,1320305325,1320309201,6,3876
9093,1320305271,1320305280,1320315322,9,10042
8986,1320064784,1320064796,1320316001,12,251205
9090,1320304880,1320304890,1320323009,10,18119
9091,1320304928,1320304935,1320327237,7,22302
8915,1319877777,1319877796,1320329902,19,452106
9100,1320331222,1320331230,1320331667,8,437
9105,1320337001,1320337005,1320337021,4,16
9104,1320336975,1320336990,1320337020,15,30
9106,1320337024,1320337035,1320337040,11,5
9107,1320337050,1320337066,1320337127,16,61
9108,1320337074,1320337080,1320337126,6,46
9109,1320337188,1320337200,1320337203,12,3
9110,1320337322,1320337335,1320337338,13,3
9111,1320337635,1320337650,1320337653,15,3
9112,1320337738,1320337740,1320337753,2,13
9113,1320337803,1320337815,1320337818,12,3
9114,1320337996,1320338010,1320338131,14,121
9115,1320338914,1320338925,1320338929,11,4
9116,1320339064,1320339075,1320339157,11,82
9073,1320222860,1320222870,1320338801,10,115931
9117,1320339451,1320339465,1320339469,14,4
9118,1320340387,1320340395,1320340399,8,4
9095,1320323627,1320323640,1320341588,13,17948
9096,1320329803,1320329805,1320349819,2,20014
9102,1320331845,1320331860,1320358822,15,26962
9051,1320137731,1320137741,1320381248,10,243507
9103,1320331848,1320331860,1320393232,12,61372
9119,1320401302,1320401310,1320401328,8,18
9101,1320331842,1320331850,1320402455,8,70605
9122,1320404716,1320404731,1320404733,15,2
9123,1320404782,1320404790,1320405064,8,274
9124,1320405305,1320405315,1320405317,10,2
9125,1320405372,1320405375,1320405376,3,1
9126,1320405401,1320405405,1320405411,4,6
9127,1320409517,1320409524,1320409529,7,5
9128,1320409523,1320409524,1320409529,1,5
9131,1320412058,1320412059,1320412062,1,3
8987,1320064790,1320064796,1320412134,6,347338
9132,1320412207,1320412209,1320412215,2,6
9134,1320413328,1320413334,1320413344,6,10
9135,1320413388,1320413394,1320413398,6,4
9136,1320414131,1320414144,1320414148,13,4
9137,1320414143,1320414144,1320414154,1,10
9139,1320420255,1320420264,1320420270,9,6
9133,1320412871,1320412884,1320439110,13,26226
9138,1320417967,1320417969,1320453298,2,35329
8099,1317720105,1317720116,1320460774,11,2740658
9145,1320484435,1320484449,1320484571,14,122
9144,1320484425,1320484434,1320484572,9,138
9146,1320485217,1320485229,1320485292,12,63
9147,1320485450,1320485454,1320485555,4,101
9149,1320485930,1320485934,1320485985,4,51
9150,1320486043,1320486054,1320486152,11,98
9151,1320486230,1320486234,1320486286,4,52
9152,1320486472,1320486474,1320486494,2,20
9148,1320485574,1320485589,1320488435,15,2846
9143,1320484422,1320484436,1320488465,14,4029
9153,1320489191,1320489204,1320489205,13,1
9154,1320489266,1320489279,1320489369,13,90
9158,1320490945,1320490959,1320490959,14,0
9157,1320490936,1320490944,1320491044,8,100
9159,1320492561,1320492564,1320492655,3,91
9155,1320489645,1320489656,1320493275,11,3619
9156,1320490440,1320490449,1320493386,9,2937
9160,1320505291,1320505299,1320505566,8,267
9163,1320505914,1320505929,1320506013,15,84
8874,1319795352,1319795366,1320506034,14,710668
9162,1320505636,1320505644,1320506072,8,428
9164,1320506641,1320506649,1320506739,8,90
9165,1320506741,1320506754,1320506774,13,20
9166,1320506833,1320506844,1320506905,11,61
9167,1320507144,1320507159,1320507244,15,85
9168,1320507383,1320507384,1320507481,1,97
9169,1320507669,1320507684,1320507781,15,97
9161,1320505564,1320505570,1320508895,6,3325
9170,1320509183,1320509184,1320509234,1,50
9171,1320511469,1320511479,1320511483,10,4
9173,1320511675,1320511689,1320511789,14,100
9174,1320511950,1320511959,1320512022,9,63
9172,1320511631,1320511646,1320512337,15,691
9074,1320223411,1320223425,1320524559,14,301134
9142,1320426032,1320453324,1320554088,27292,100764
8720,1319531173,1319531186,1320564324,13,1033138
9179,1320575382,1320575394,1320575419,12,25
9180,1320575385,1320575394,1320575409,9,15
9181,1320575391,1320575395,1320575461,4,66
9183,1320575435,1320575439,1320575583,4,144
9182,1320575397,1320575410,1320575649,13,239
9184,1320575731,1320575739,1320575762,8,23
9185,1320575817,1320575831,1320575837,14,6
9186,1320575861,1320575874,1320575912,13,38
9187,1320576074,1320576086,1320576102,12,16
9188,1320576177,1320576189,1320576293,12,104
9190,1320576303,1320576309,1320576395,6,86
9189,1320576240,1320576251,1320576393,11,142
9191,1320576435,1320576444,1320576549,9,105
9192,1320576583,1320576596,1320576603,13,7
9193,1320576891,1320576894,1320576983,3,89
9194,1320576958,1320576971,1320577163,13,192
9195,1320577145,1320577151,1320577301,6,150
9196,1320577409,1320577419,1320577437,10,18
9197,1320577526,1320577542,1320577755,16,213
9198,1320578390,1320578394,1320578446,4,52
9199,1320578532,1320578547,1320578691,15,144
9121,1320402468,1320402480,1320598366,12,195886
8112,1317805083,1317805091,1320599640,8,2794549
9208,1320605339,1320605349,1320605349,10,0
9209,1320605342,1320605349,1320605349,7,0
9177,1320569240,1320569244,1320610703,4,41459
8395,1319019753,1319019761,1320630036,8,1610275
9176,1320569200,1320569214,1320670529,14,101315
9175,1320568980,1320568989,1320672908,9,103919
9213,1320654076,1320654084,1320673987,8,19903
9216,1320674139,1320674154,1320674158,15,4
9221,1320676260,1320676269,1320676352,9,83
9222,1320676310,1320676314,1320676352,4,38
9225,1320677068,1320677079,1320677091,11,12
9227,1320678542,1320678549,1320678549,7,0
9214,1320654939,1320654954,1320688007,15,33053
9200,1320605317,1320605319,1320692770,2,87451
9220,1320675080,1320675084,1320693048,4,17964
9203,1320605324,1320671199,1320693225,65875,22026
9231,1320693140,1320693144,1320698157,4,5013
9232,1320693344,1320693354,1320725918,10,32564
9228,1320680145,1320680155,1320738671,10,58516
9233,1320748681,1320748689,1320772482,8,23793
9097,1320330877,1320330885,1320774668,8,443783
9055,1320141516,1320141521,1320782507,5,640986
7941,1316650868,1316655880,1320823167,5012,4167287
9243,1320837657,1320837669,1320837671,12,2
9244,1320837794,1320837804,1320837806,10,2
9245,1320838122,1320838134,1320838136,12,2
9246,1320838207,1320838209,1320838211,2,2
9247,1320838595,1320838599,1320838606,4,7
9248,1320838651,1320838659,1320838661,8,2
9249,1320838748,1320838749,1320838858,1,109
9250,1320839157,1320839169,1320839251,12,82
9251,1320839319,1320839334,1320839367,15,33
9229,1320680172,1320680184,1320846192,12,166008
9236,1320824464,1320824469,1320848877,5,24408
9241,1320826329,1320826344,1320849672,15,23328
9252,1320839492,1320839499,1320850758,7,11259
9254,1320839704,1320839709,1320853235,5,13526
9257,1320849049,1320849054,1320855299,5,6245
9266,1320858608,1320858609,1320858642,1,33
9267,1320858690,1320858699,1320858732,9,33
9242,1320836767,1320836770,1320864696,3,27926
9268,1320858815,1320858819,1320870084,4,11265
9202,1320605322,1320605334,1320873894,12,268560
9264,1320850665,1320853239,1320899311,2574,46072
9099,1320331066,1320331080,1320911154,14,580074
9273,1320917990,1320917994,1320917998,4,4
9271,1320917981,1320917994,1320918002,13,8
9272,1320917985,1320917994,1320918002,9,8
9274,1320918073,1320918084,1320918088,11,4
9276,1320918292,1320918294,1320918299,2,5
9277,1320918963,1320918969,1320918973,6,4
9278,1320919122,1320919134,1320919196,12,62
9279,1320919468,1320919479,1320919512,11,33
9280,1320919680,1320919689,1320919722,9,33
9282,1320919963,1320919974,1320920007,11,33
9283,1320920039,1320920049,1320920082,10,33
9284,1320920105,1320920109,1320920142,4,33
9285,1320920178,1320920184,1320920217,6,33
9286,1320920251,1320920259,1320920292,8,33
9287,1320920473,1320920484,1320920517,11,33
9289,1320921356,1320921369,1320922387,13,1018
9269,1320915350,1320915354,1320922818,4,7464
9293,1320922795,1320922809,1320922843,14,34
9291,1320921988,1320922390,1320924524,402,2134
9294,1320923478,1320923484,1320925313,6,1829
9292,1320922021,1320922824,1320925909,803,3085
9297,1320924065,1320925944,1320925949,1879,5
9298,1320924470,1320925944,1320925949,1474,5
9299,1320924637,1320925989,1320925993,1352,4
9300,1320924694,1320925989,1320925993,1295,4
9302,1320925518,1320926034,1320930568,516,4534
9253,1320839530,1320839544,1320931951,14,92407
9303,1320932752,1320932754,1320935126,2,2372
9304,1320932817,1320932829,1320935153,12,2324
9305,1320935293,1320935304,1320935308,11,4
9306,1320935516,1320935529,1320935533,13,4
9307,1320935602,1320935604,1320935608,2,4
9308,1320935656,1320935664,1320935668,8,4
9309,1320935694,1320935709,1320935713,15,4
9311,1320936648,1320936655,1320936659,7,4
9310,1320936598,1320936609,1320936613,11,4
9312,1320936753,1320936759,1320936763,6,4
9313,1320937798,1320937809,1320937811,11,2
9314,1320938078,1320938079,1320938113,1,34
9316,1320939200,1320939204,1320940712,4,1508
9317,1320941347,1320941349,1320941369,2,20
9318,1320941439,1320941454,1320941530,15,76
9319,1320941527,1320941529,1320941575,2,46
9275,1320918121,1320918129,1320942246,8,24117
9320,1320941570,1320941574,1320943689,4,2115
9288,1320920544,1320920559,1320943851,15,23292
9322,1320943824,1320943839,1320943990,15,151
9323,1320943904,1320943914,1320948341,10,4427
9321,1320942620,1320942624,1320948616,4,5992
9324,1320943947,1320943959,1320949376,12,5417
9223,1320676316,1320676329,1320951224,13,274895
9256,1320842721,1320842724,1320961062,3,118338
9315,1320938148,1320938154,1320962435,6,24281
9295,1320923487,1320925329,1320971616,1842,46287
9255,1320842469,1320842484,1320983166,15,140682
9301,1320925343,1320926034,1320986590,691,60556
8343,1318932960,1318932973,1320994192,13,2061219
9327,1320998190,1320998199,1320998202,9,3
9328,1320998196,1320998199,1320998203,3,4
9329,1320998200,1320998214,1320998227,14,13
9330,1320998206,1320998214,1320998223,8,9
9331,1320998228,1320998229,1320998236,1,7
9333,1320998347,1320998349,1320998353,2,4
9332,1320998344,1320998349,1320998363,5,14
9334,1320998353,1320998364,1320998368,11,4
9335,1320998356,1320998364,1320998368,8,4
9336,1321004486,1321004499,1321004504,13,5
9235,1320824363,1320824364,1321011671,1,187307
9345,1321009703,1321011699,1321011714,1996,15
9348,1321012397,1321012404,1321012474,7,70
9359,1321022497,1321022499,1321022500,2,1
9360,1321022562,1321022574,1321022575,12,1
9361,1321022625,1321022634,1321022635,9,1
9338,1321005417,1321005429,1321024350,12,18921
9337,1321004734,1321004739,1321033244,5,28505
9350,1321012623,1321012629,1321037634,6,25005
8259,1318518581,1318518596,1321044252,15,2525656
9349,1321012509,1321012524,1321051420,15,38896
9353,1321015225,1321051465,1321051470,36240,5
9354,1321015405,1321051510,1321051516,36105,6
9355,1321016289,1321051539,1321051543,35250,4
9356,1321016423,1321051584,1321051588,35161,4
9357,1321020619,1321051629,1321051633,31010,4
9358,1321020691,1321051659,1321051665,30968,6
9364,1321025013,1321051704,1321057956,26691,6252
9259,1320849301,1320849309,1321071976,8,222667
8737,1319538004,1319538011,1321093377,7,1555366
9365,1321029761,1321072014,1321093414,42253,21400
8740,1319538055,1319538056,1321093559,1,1555503
8113,1317805746,1317805751,1321093588,5,3287837
9258,1320849146,1320849159,1321101434,13,252275
9212,1320606148,1320606159,1321108380,11,502221
9343,1321008274,1321011744,1321113213,3470,101469
9351,1321013286,1321033254,1321128357,19968,95103
9372,1321117719,1321117734,1321140149,15,22415
9339,1321007039,1321007049,1321154231,10,147182
9370,1321117654,1321117659,1321163446,5,45787
9371,1321117692,1321117704,1321179524,12,61820
9375,1321182777,1321182789,1321182795,12,6
9376,1321182784,1321182790,1321182795,6,5
9342,1321007553,1321007559,1321183391,6,175832
9377,1321183678,1321183689,1321183689,11,0
9380,1321184118,1321184125,1321184129,7,4
9379,1321184114,1321184124,1321184129,10,5
9381,1321184237,1321184244,1321188156,7,3912
9352,1321013451,1321037694,1321197042,24243,159348
9098,1320330988,1320330990,1321232974,2,901984
9369,1321116920,1321116924,1321257154,4,140230
9386,1321259556,1321259559,1321259571,3,12
9388,1321260078,1321260084,1321260095,6,11
9389,1321260343,1321260354,1321260364,11,10
9390,1321260420,1321260429,1321260433,9,4
9391,1321260456,1321260459,1321260463,3,4
9392,1321260473,1321260474,1321260475,1,1
9393,1321260653,1321260654,1321260657,1,3
9394,1321260760,1321260774,1321260777,14,3
9395,1321260944,1321260954,1321260957,10,3
9396,1321260967,1321260969,1321260972,2,3
9397,1321261628,1321261629,1321261639,1,10
9398,1321261903,1321261914,1321261916,11,2
9399,1321261959,1321261974,1321261986,15,12
9400,1321262006,1321262019,1321262029,13,10
9401,1321262333,1321262334,1321262336,1,2
9402,1321262431,1321262439,1321262442,8,3
9403,1321262569,1321262574,1321262577,5,3
7619,1313359008,1313359019,1321263536,11,7904517
9406,1321263316,1321263565,1321263571,249,6
9420,1321263462,1321263565,1321263570,103,5
9407,1321263324,1321263610,1321263616,286,6
9408,1321263328,1321263610,1321263616,282,6
9409,1321263332,1321263610,1321263616,278,6
9410,1321263335,1321263610,1321263615,275,5
9411,1321263340,1321263640,1321263646,300,6
9412,1321263344,1321263640,1321263646,296,6
9413,1321263347,1321263640,1321263646,293,6
9414,1321263351,1321263640,1321263646,289,6
9415,1321263358,1321263685,1321263692,327,7
9416,1321263361,1321263685,1321263692,324,7
9421,1321263639,1321263685,1321263723,46,38
9417,1321263364,1321263730,1321263735,366,5
9418,1321263380,1321263730,1321263735,350,5
9419,1321263387,1321263759,1321263764,372,5
9405,1321263025,1321263039,1321263838,14,799
9423,1321263879,1321263894,1321263899,15,5
9424,1321264106,1321264119,1321264122,13,3
9425,1321264234,1321264239,1321265176,5,937
9426,1321264295,1321265184,1321265932,889,748
9296,1320923545,1320924564,1321270975,1019,346411
8739,1319538032,1319538041,1321271094,9,1733053
9429,1321264757,1321271109,1321271129,6352,20
9432,1321268444,1321271109,1321271127,2665,18
9430,1321264794,1321271154,1321271156,6360,2
9433,1321268731,1321271154,1321271156,2423,2
9434,1321268812,1321271154,1321271156,2342,2
9435,1321271369,1321271379,1321271382,10,3
9436,1321271754,1321271769,1321271769,15,0
9437,1321271832,1321271844,1321271844,12,0
9438,1321271870,1321271874,1321271877,4,3
9439,1321271960,1321271964,1321271965,4,1
9440,1321271983,1321271994,1321271994,11,0
9281,1320919749,1320919764,1321272054,15,352290
9441,1321272099,1321272114,1321272116,15,2
9442,1321272136,1321272144,1321272146,8,2
9443,1321272298,1321272309,1321272310,11,1
9444,1321272301,1321272309,1321272310,8,1
9445,1321272307,1321272309,1321272309,2,0
9446,1321272760,1321272774,1321272775,14,1
9447,1321273413,1321273419,1321273419,6,0
9448,1321275087,1321275099,1321275141,12,42
9449,1321275394,1321275399,1321275399,5,0
9450,1321277573,1321277574,1321277577,1,3
9451,1321278053,1321278054,1321278076,1,22
9452,1321278122,1321278129,1321278132,7,3
9453,1321278180,1321278189,1321278192,9,3
9454,1321278304,1321278309,1321278312,5,3
9455,1321278469,1321278474,1321278477,5,3
9456,1321278528,1321278534,1321278537,6,3
9458,1321278610,1321278624,1321278625,14,1
9457,1321278605,1321278609,1321278612,4,3
9459,1321278775,1321278789,1321278792,14,3
9460,1321278852,1321278864,1321278865,12,1
9461,1321278975,1321278984,1321278986,9,2
9462,1321279006,1321279014,1321279015,8,1
9463,1321279246,1321279254,1321279284,8,30
8149,1318177965,1318177976,1321280230,11,3102254
9464,1321280295,1321280304,1321280306,9,2
9465,1321280297,1321280304,1321280307,7,3
9466,1321280300,1321280304,1321280305,4,1
9467,1321280303,1321280304,1321280305,1,1
9469,1321280311,1321280319,1321280392,8,73
9468,1321280307,1321280319,1321280399,12,80
9472,1321284247,1321284249,1321284323,2,74
9261,1320850183,1320850194,1321284382,11,434188
9476,1321288074,1321288089,1321288093,15,4
9477,1321288158,1321288164,1321288167,6,3
9478,1321288250,1321288254,1321288255,4,1
9473,1321284366,1321284369,1321290561,3,6192
9385,1321259516,1321259529,1321304677,13,45148
9387,1321259593,1321259604,1321308833,11,49229
9428,1321264424,1321271004,1321311155,6580,40151
9260,1320849487,1320849489,1321311844,2,462355
9427,1321264383,1321265949,1321316089,1566,50140
9344,1321008785,1321024389,1321316956,15604,292567
9378,1321183795,1321183809,1321325140,14,141331
9474,1321286261,1321286274,1321329816,13,43542
9384,1321257181,1321257189,1321353805,8,96616
9484,1321361875,1321361889,1321361892,14,3
9475,1321286264,1321290564,1321382812,4300,92248
9479,1321353574,1321353579,1321433711,5,80132
9488,1321441019,1321441029,1321443520,10,2491
9404,1321262735,1321262739,1321487507,4,224768
9486,1321440641,1321440654,1321490220,13,49566
9489,1321514390,1321514394,1321517256,4,2862
9262,1320850312,1320850314,1321521270,2,670956
9492,1321523522,1321523529,1321523536,7,7
9493,1321523558,1321523559,1321523592,1,33
9494,1321523627,1321523634,1321523795,7,161
9495,1321523770,1321523784,1321523789,14,5
9496,1321523969,1321523979,1321523984,10,5
9499,1321524189,1321524204,1321526989,15,2785
9501,1321527017,1321527024,1321528933,7,1909
9502,1321527143,1321527144,1321529068,1,1924
9498,1321524157,1321524159,1321529659,2,5500
9487,1321440643,1321440654,1321548894,11,108240
9507,1321546264,1321548924,1321554770,2660,5846
9263,1320850437,1320850765,1321556385,328,705620
9509,1321546538,1321556439,1321556471,9901,32
9504,1321530372,1321530384,1321560287,12,29903
9508,1321546343,1321554774,1321560618,8431,5844
9505,1321530502,1321530504,1321565102,2,34598
9512,1321573544,1321573554,1321573555,10,1
9513,1321573626,1321573629,1321573630,3,1
9514,1321573776,1321573779,1321573780,3,1
9515,1321573972,1321573974,1321573974,2,0
9516,1321574110,1321574124,1321574125,14,1
9341,1321007045,1321007049,1321583048,4,575999
9373,1321119121,1321119129,1321584967,8,465838
9362,1321022691,1321022694,1321596350,3,573656
9517,1321600608,1321600614,1321600621,6,7
9471,1321283781,1321283785,1321619913,4,336128
9500,1321524217,1321524219,1321624702,2,100483
9520,1321631045,1321631049,1321631050,4,1
9522,1321631463,1321631469,1321631473,6,4
9523,1321631740,1321631754,1321631754,14,0
9524,1321631813,1321631814,1321631815,1,1
9525,1321633438,1321633449,1321633449,11,0
9526,1321634497,1321634499,1321634500,2,1
9528,1321634583,1321634589,1321634592,6,3
9529,1321634749,1321634754,1321634757,5,3
9530,1321634824,1321634829,1321634841,5,12
9532,1321635021,1321635024,1321635042,3,18
9533,1321635721,1321635729,1321635738,8,9
9534,1321636211,1321636224,1321636233,13,9
9506,1321531669,1321531674,1321652810,5,121136
9224,1320676424,1320676434,1321661820,10,985386
9497,1321524149,1321524159,1321666624,10,142465
9485,1321437268,1321624719,1321705234,187451,80515
9519,1321604806,1321604814,1321723421,8,118607
9482,1321354039,1321354044,1321729944,5,375900
9535,1321740481,1321740489,1321740489,8,0
9536,1321740596,1321740609,1321740702,13,93
9383,1321200393,1321200399,1321797888,6,597489
9290,1320921669,1320921685,1321800347,16,878662
9470,1321281924,1321281940,1321810331,16,528391
9366,1321092402,1321093404,1321820190,1002,726786
9539,1321741350,1321741359,1321822555,9,81196
9548,1321871552,1321871559,1321871793,7,234
9540,1321775387,1321810389,1321873932,35002,63543
9552,1321874691,1321874695,1321874721,4,26
9543,1321869190,1321869204,1321875050,14,5846
9555,1321876037,1321876044,1321876048,7,4
9544,1321869520,1321869534,1321876729,14,7195
9541,1321775429,1321775439,1321885230,10,109791
9545,1321869931,1321869939,1321891741,8,21802
9558,1321892965,1321892979,1321893003,14,24
9559,1321892975,1321892980,1321893003,5,23
9560,1321892981,1321893099,1321893105,118,6
9510,1321549939,1321705254,1321906246,155315,200992
9554,1321875809,1321875819,1321908114,10,32295
9565,1321893605,1321908144,1321908168,14539,24
9566,1321893631,1321908249,1321908273,14618,24
9551,1321874114,1321874124,1321914222,10,40098
9553,1321874776,1321874784,1321919255,8,44471
9562,1321893241,1321893249,1321928649,8,35400
9564,1321893464,1321893474,1321932005,10,38531
9563,1321893349,1321893354,1321932302,5,38948
9542,1321864612,1321864614,1321946779,2,82165
9568,1321950477,1321950489,1321950879,12,390
9569,1321952713,1321952724,1321952725,11,1
9570,1321952843,1321952844,1321952846,1,2
9571,1321952924,1321952934,1321952935,10,1
9572,1321953034,1321953039,1321953040,5,1
9567,1321950263,1321950264,1321953160,1,2896
9573,1321953238,1321953249,1321954396,11,1147
9580,1321956505,1321956520,1321956553,15,33
9585,1321956829,1321956834,1321956940,5,106
9587,1321957113,1321957119,1321957143,6,24
9588,1321957301,1321957314,1321957337,13,23
9490,1321515311,1321515324,1321957453,13,442129
9589,1321957382,1321957389,1321957877,7,488
9590,1321958388,1321958394,1321958417,6,23
9584,1321956642,1321956654,1321958475,12,1821
9581,1321956524,1321956534,1321958511,10,1977
9582,1321956538,1321956549,1321958546,11,1997
9583,1321956555,1321956564,1321958790,9,2226
9593,1321958861,1321958874,1321958879,13,5
9596,1321961314,1321961319,1321961445,5,126
9576,1321956417,1321956429,1321962064,12,5635
9577,1321956448,1321956459,1321962284,11,5825
9578,1321956461,1321956474,1321962355,13,5881
9597,1321961490,1321961499,1321962599,9,1100
9579,1321956478,1321956489,1321962750,11,6261
9600,1321962746,1321962759,1321962792,13,33
9598,1321961638,1321961649,1321962892,11,1243
9607,1321963100,1321963104,1321963121,4,17
9599,1321962665,1321962669,1321963395,4,726
9608,1321963102,1321963404,1321963437,302,33
9610,1321963160,1321963449,1321963482,289,33
9606,1321963031,1321963044,1321963489,13,445
9613,1321963221,1321963479,1321963512,258,33
9609,1321963154,1321963495,1321963518,341,23
9340,1321007041,1321007049,1321965789,8,958740
8114,1317806125,1317806126,1321965826,1,4159700
9616,1321963589,1321965849,1321965882,2260,33
9620,1321965937,1321965939,1321965962,2,23
9621,1321965996,1321966044,1321966068,48,24
9622,1321966102,1321966119,1321966122,17,3
9603,1321962854,1321962864,1321966433,10,3569
9594,1321958890,1321958904,1321968139,14,9235
9615,1321963545,1321965804,1321971091,2259,5287
9574,1321955874,1321956264,1321973217,390,16953
9605,1321962934,1321962939,1321973822,5,10883
9601,1321962809,1321962819,1321975177,10,12358
9627,1321966963,1321973829,1321979375,6866,5546
9637,1321972239,1321979379,1321979381,7140,2
9617,1321963677,1321979649,1321979665,15972,16
9628,1321967004,1321979709,1321979713,12705,4
9625,1321966212,1321975194,1321984863,8982,9669
9586,1321957075,1321957089,1321990137,14,33048
9630,1321967366,1321984869,1321994287,17503,9418
9604,1321962888,1321962894,1322000147,6,37253
9629,1321967058,1321979724,1322001409,12666,21685
9633,1321967827,1322000154,1322024414,32327,24260
9632,1321967730,1321994319,1322024439,26589,30120
9575,1321956282,1321956294,1322028314,12,72020
9634,1321968020,1322001444,1322032620,33424,31176
9642,1321981367,1322032644,1322032648,51277,4
9556,1321876094,1321876104,1322040941,10,164837
9645,1322039007,1322040969,1322041002,1962,33
9644,1322038444,1322038449,1322043687,5,5238
9651,1322043882,1322043894,1322043927,12,33
9652,1322044126,1322044134,1322044167,8,33
9653,1322044208,1322044209,1322044242,1,33
9654,1322044315,1322044329,1322044362,14,33
9650,1322043547,1322043549,1322044374,2,825
9655,1322044435,1322044449,1322044451,14,2
9656,1322045790,1322045799,1322045832,9,33
9657,1322045854,1322045859,1322049064,5,3205
9659,1322048935,1322049069,1322049102,134,33
9660,1322049627,1322049639,1322049672,12,33
9661,1322049946,1322049954,1322049976,8,22
9662,1322050010,1322050014,1322056051,4,6037
9623,1321966145,1321966164,1322056043,19,89879
9672,1322056741,1322056749,1322056773,8,24
9673,1322056832,1322056839,1322056864,7,25
9674,1322056935,1322056944,1322056970,9,26
9675,1322057124,1322057139,1322057164,15,25
9676,1322060556,1322060559,1322065135,3,4576
9677,1322060690,1322065149,1322065182,4459,33
9678,1322065433,1322065434,1322065459,1,25
9679,1322065476,1322065479,1322065501,3,22
9658,1322047622,1322047629,1322066600,7,18971
9480,1321353778,1321353834,1322068235,56,714401
9663,1322050231,1322056089,1322068847,5858,12758
9211,1320605559,1320605574,1322069624,15,1464050
9680,1322065521,1322065524,1322073143,3,7619
9557,1321876203,1321876209,1322079833,6,203624
9664,1322050412,1322066649,1322085413,16237,18764
9641,1321981040,1322028339,1322087503,47299,59164
9483,1321354203,1321354209,1322094234,6,740025
9665,1322050626,1322068899,1322097361,18273,28462
9491,1321515329,1321515339,1322097720,10,582381
9549,1321873513,1321873524,1322100534,11,227010
9647,1322041572,1322100579,1322100599,59007,20
9648,1322041588,1322100699,1322100718,59111,19
9640,1321980431,1322024484,1322122395,44053,97911
9624,1321966177,1321971129,1322124271,4952,153142
9611,1321963190,1321963599,1322127813,409,164214
9671,1322054897,1322097384,1322130969,42487,33585
9631,1321967399,1321990194,1322131159,22795,140965
9690,1322131709,1322131719,1322131720,10,1
9691,1322131762,1322131764,1322131817,2,53
9692,1322131832,1322131839,1322131904,7,65
9694,1322132068,1322132079,1322132112,11,33
9695,1322132154,1322132169,1322132202,15,33
9696,1322133139,1322133144,1322133177,5,33
9701,1322133825,1322133834,1322133835,9,1
9693,1322132020,1322132034,1322134195,14,2161
9614,1321963314,1321963599,1322134620,285,171021
9685,1322124232,1322134659,1322134659,10427,0
9592,1321958562,1321958574,1322135820,12,177246
9697,1322133217,1322133234,1322141945,17,8711
9702,1322142091,1322142099,1322142100,8,1
9703,1322142182,1322142189,1322142210,7,21
9704,1322142230,1322142234,1322142265,4,31
9705,1322142280,1322142294,1322143509,14,1215
9706,1322143679,1322143689,1322147165,10,3476
9561,1321893093,1321893099,1322147361,6,254262
9707,1322143759,1322143764,1322152627,5,8863
9708,1322143789,1322143794,1322153300,5,9506
9714,1322156117,1322156139,1322157694,22,1555
9716,1322156204,1322156214,1322158780,10,2566
9715,1322156174,1322156184,1322158944,10,2760
9668,1322052323,1322085489,1322168910,33166,83421
9670,1322052411,1322094264,1322175817,41853,81553
9687,1322126011,1322127849,1322184088,1838,56239
9669,1322052336,1322087559,1322184713,35223,97154
9688,1322126347,1322144634,1322191492,18287,46858
9595,1321960527,1321960539,1322195939,12,235400
9591,1321958470,1321958484,1322198599,14,240115
9717,1322208975,1322208984,1322209000,9,16
9718,1322209156,1322209164,1322209183,8,19
9720,1322216582,1322216589,1322216594,7,5
9721,1322216638,1322216649,1322216873,11,224
9722,1322216892,1322216904,1322216908,12,4
9719,1322215600,1322215614,1322217274,14,1660
9724,1322217512,1322217519,1322217535,7,16
9725,1322217548,1322217549,1322217565,1,16
9732,1322218452,1322218464,1322218464,12,0
9733,1322218539,1322218554,1322218554,15,0
9734,1322218966,1322218974,1322218975,8,1
9729,1322217841,1322217864,1322220040,23,2176
9723,1322217451,1322217459,1322220347,8,2888
9736,1322221088,1322221090,1322221432,2,342
9730,1322217983,1322217984,1322222685,1,4701
9737,1322223370,1322223384,1322223505,14,121
9738,1322224190,1322224194,1322224194,4,0
9739,1322224284,1322224299,1322224299,15,0
9740,1322224437,1322224449,1322224455,12,6
9741,1322224703,1322224704,1322224711,1,7
9742,1322224824,1322224839,1322224864,15,25
9727,1322217590,1322217594,1322225738,4,8144
9743,1322225148,1322225154,1322225896,6,742
9747,1322226993,1322227000,1322227063,7,63
9748,1322227123,1322227134,1322227166,11,32
9749,1322227208,1322227209,1322227257,1,48
9750,1322227387,1322227389,1322227389,2,0
9751,1322227468,1322227479,1322227489,11,10
9752,1322227595,1322227599,1322227609,4,10
9753,1322227714,1322227719,1322227736,5,17
9754,1322227777,1322227779,1322227779,2,0
9755,1322227880,1322227884,1322227892,4,8
9756,1322227959,1322227974,1322228254,15,280
9758,1322228326,1322228334,1322228347,8,13
9759,1322228398,1322228409,1322228425,11,16
9726,1322217577,1322217579,1322228490,2,10911
9760,1322228439,1322228454,1322228496,15,42
9731,1322218051,1322218059,1322228545,8,10486
9761,1322228567,1322228574,1322228596,7,22
9762,1322228624,1322228634,1322228648,10,14
9763,1322228663,1322228664,1322228739,1,75
9764,1322228799,1322228814,1322228846,15,32
9765,1322229018,1322229024,1322229025,6,1
9767,1322229376,1322229384,1322229416,8,32
9768,1322229437,1322229444,1322229445,7,1
9766,1322229159,1322229174,1322231946,15,2772
9770,1322231970,1322231979,1322231980,9,1
9546,1321870497,1321870509,1322235177,12,364668
9744,1322225287,1322225289,1322235729,2,10440
9728,1322217753,1322217759,1322238029,6,20270
9619,1321965705,1321966449,1322244464,744,278015
9769,1322229719,1322229730,1322246026,11,16296
9757,1322228222,1322228229,1322247368,7,19139
9639,1321980377,1322024424,1322271604,44047,247180
9204,1320605327,1320605334,1322272541,7,1667207
9774,1322314460,1322314464,1322314904,4,440
9777,1322314934,1322314944,1322315040,10,96
9778,1322314936,1322314944,1322315469,8,525
9776,1322314915,1322314929,1322315512,14,583
9775,1322314479,1322314494,1322315515,15,1021
9773,1322303629,1322303634,1322315596,5,11962
9686,1322125306,1322130984,1322318345,5678,187361
9709,1322143912,1322145534,1322318775,1622,173241
9779,1322315003,1322315064,1322323391,61,8327
9780,1322315048,1322315499,1322325426,451,9927
9547,1321871182,1321871185,1322326615,3,455430
9698,1322133419,1322134689,1322326719,1270,192030
9689,1322126836,1322131194,1322328021,4358,196827
9783,1322328174,1322328189,1322329236,15,1047
9772,1322302117,1322302119,1322332130,2,30011
9784,1322332370,1322332374,1322332403,4,29
9481,1321353863,1321433724,1322334302,79861,900578
9666,1322051531,1322079879,1322347263,28348,267384
9788,1322338348,1322338359,1322347348,11,8989
9422,1321263777,1321263804,1322357072,27,1093268
9787,1322338250,1322338254,1322374991,4,36737
9771,1322237412,1322237424,1322379115,12,141691
9786,1322335891,1322335899,1322395842,8,59943
9795,1322424171,1322424174,1322424175,3,1
9785,1322335887,1322335899,1322448949,12,113050
9550,1321873577,1321873585,1322454739,8,581154
9794,1322424021,1322424024,1322465386,3,41362
9796,1322468390,1322468394,1322468427,4,33
9797,1322468462,1322468469,1322468470,7,1
9798,1322468539,1322468544,1322468545,5,1
9801,1322468745,1322468754,1322468759,9,5
9638,1321973213,1322032689,1322469773,59476,437084
9807,1322470282,1322470284,1322470286,2,2
9808,1322470333,1322470344,1322470345,11,1
9809,1322470500,1322470509,1322470515,9,6
9810,1322470561,1322470569,1322470570,8,1
9811,1322470623,1322470629,1322470690,6,61
9812,1322470817,1322470824,1322470897,7,73
9813,1322471620,1322471634,1322471636,14,2
9814,1322471846,1322471859,1322473491,13,1632
9800,1322468692,1322468694,1322473534,2,4840
9815,1322472079,1322472084,1322473828,5,1744
9828,1322474516,1322474529,1322474532,13,3
9830,1322474565,1322474574,1322474576,9,2
9829,1322474519,1322474529,1322474536,10,7
9799,1322468612,1322468619,1322474647,7,6028
9834,1322474623,1322474636,1322474685,13,49
9835,1322474771,1322474784,1322474832,13,48
9836,1322474889,1322474904,1322474905,15,1
9838,1322475091,1322475099,1322475112,8,13
9803,1322468977,1322468979,1322475145,2,6166
9839,1322475152,1322475159,1322475177,7,18
9837,1322474947,1322474949,1322475352,2,403
9841,1322475440,1322475444,1322475452,4,8
9842,1322475522,1322475534,1322475541,12,7
9824,1322474053,1322474139,1322475547,86,1408
9843,1322475644,1322475654,1322475922,10,268
9827,1322474062,1322474139,1322476207,77,2068
9826,1322474059,1322474139,1322476245,80,2106
9825,1322474057,1322474139,1322476312,82,2173
9820,1322473354,1322473359,1322476952,5,3593
9844,1322477387,1322477394,1322477395,7,1
9845,1322477463,1322477469,1322477502,6,33
9840,1322475295,1322475309,1322477573,14,2264
9847,1322477541,1322477544,1322477577,3,33
9850,1322478096,1322478099,1322478117,3,18
9833,1322474621,1322474634,1322478329,13,3695
9846,1322477473,1322477484,1322479145,11,1661
9849,1322477873,1322477874,1322479568,1,1694
9832,1322474611,1322474619,1322479772,8,5153
9853,1322480450,1322480454,1322480455,4,1
9854,1322480519,1322480529,1322480529,10,0
9855,1322480654,1322480664,1322480664,10,0
9848,1322477602,1322477604,1322480707,2,3103
9856,1322480715,1322480724,1322480725,9,1
9851,1322478198,1322478204,1322480728,6,2524
9858,1322480808,1322480814,1322480815,6,1
9859,1322480854,1322480859,1322480861,5,2
9860,1322480885,1322480889,1322480890,4,1
9861,1322480931,1322480934,1322480966,3,32
9862,1322481015,1322481024,1322481031,9,7
9864,1322481108,1322481114,1322481115,6,1
9865,1322481143,1322481144,1322481152,1,8
9868,1322481496,1322481504,1322481504,8,0
9866,1322481197,1322481204,1322481564,7,360
9869,1322481554,1322481564,1322481632,10,68
9802,1322468855,1322468859,1322481718,4,12859
9816,1322472800,1322472804,1322483318,4,10514
9872,1322484021,1322484024,1322484024,3,0
9873,1322484070,1322484084,1322484094,14,10
9818,1322473205,1322473209,1322484659,4,11450
9870,1322483249,1322483259,1322484929,10,1670
9857,1322480749,1322480754,1322485228,5,4474
9852,1322479857,1322479870,1322485735,13,5865
9875,1322486451,1322486455,1322486463,4,8
9819,1322473283,1322473284,1322486972,1,13688
9804,1322469049,1322469054,1322487872,5,18818
9871,1322483511,1322483514,1322492770,3,9256
9863,1322481026,1322481040,1322493942,14,12902
9881,1322497090,1322497104,1322499764,14,2660
9882,1322497107,1322497119,1322500207,12,3088
9880,1322497050,1322497059,1322501497,9,4438
9879,1322497035,1322497044,1322501939,9,4895
9878,1322497017,1322497029,1322502101,12,5072
9876,1322487985,1322487999,1322505788,14,17789
9817,1322473158,1322473164,1322508629,6,35465
9805,1322469103,1322469114,1322513597,11,44483
9821,1322473419,1322473434,1322514008,15,40574
9884,1322500155,1322505850,1322515196,5695,9346
9883,1322500017,1322500030,1322516694,13,16664
9831,1322474609,1322474620,1322518068,11,43448
9867,1322481243,1322484701,1322519603,3458,34902
9885,1322500534,1322508639,1322520905,8105,12266
9874,1322484651,1322485269,1322543629,618,58360
9888,1322559720,1322559729,1322559733,9,4
9896,1322561507,1322561507,1322561510,0,3
9887,1322557425,1322557434,1322565414,9,7980
9901,1322567762,1322567777,1322567780,15,3
9893,1322560805,1322560809,1322568540,4,7731
9892,1322560800,1322560809,1322568865,9,8056
9891,1322560793,1322560794,1322569719,1,8925
9903,1322570753,1322570762,1322570795,9,33
9899,1322562122,1322562137,1322570959,15,8822
9906,1322571331,1322571332,1322571338,1,6
9907,1322571672,1322571677,1322571680,5,3
9908,1322578185,1322578187,1322578248,2,61
9781,1322315360,1322315364,1322578483,4,263119
9909,1322578596,1322578607,1322578612,11,5
9900,1322566908,1322566922,1322580800,14,13878
9895,1322560818,1322560824,1322581323,6,20499
9894,1322560814,1322560824,1322581413,10,20589
9910,1322581996,1322581997,1322582004,1,7
9911,1322582229,1322582237,1322582243,8,6
9912,1322582533,1322582537,1322582542,4,5
9913,1322582653,1322582657,1322582663,4,6
9915,1322582940,1322582942,1322582983,2,41
9914,1322582937,1322582942,1322583070,5,128
9917,1322582946,1322582957,1322583048,11,91
9916,1322582943,1322582957,1322583423,14,466
9919,1322583572,1322583587,1322583903,15,316
9918,1322583433,1322583437,1322585684,4,2247
9904,1322570911,1322570912,1322591173,1,20261
9822,1322473577,1322473585,1322600985,8,127400
9902,1322570693,1322570717,1322609862,24,39145
9206,1320605333,1320605334,1322611643,1,2006309
9646,1322041518,1322068269,1322628196,26751,559927
9898,1322562023,1322562032,1322632978,9,70946
9921,1322642402,1322642417,1322642421,15,4
9823,1322473935,1322473944,1322648238,9,174294
9922,1322649243,1322649257,1322649261,14,4
9923,1322649332,1322649347,1322649351,15,4
9924,1322649649,1322649662,1322649667,13,5
9925,1322650345,1322650352,1322650357,7,5
9926,1322650644,1322650652,1322650656,8,4
9927,1322650759,1322650772,1322650776,13,4
9928,1322650763,1322650772,1322650776,9,4
9929,1322651032,1322651042,1322651046,10,4
9930,1322651188,1322651193,1322651201,5,8
9931,1322651376,1322651387,1322651393,11,6
9932,1322651475,1322651477,1322651483,2,6
9934,1322651522,1322651537,1322651539,15,2
9933,1322651517,1322651522,1322651525,5,3
9935,1322651600,1322651612,1322651616,12,4
9936,1322651614,1322651627,1322651631,13,4
9937,1322651814,1322651822,1322651824,8,2
9938,1322651817,1322651822,1322651826,5,4
9939,1322651936,1322651942,1322651946,6,4
9940,1322652064,1322652077,1322652080,13,3
9942,1322652203,1322652212,1322652216,9,4
9941,1322652190,1322652197,1322652201,7,4
9943,1322652699,1322652707,1322652713,8,6
9944,1322653344,1322653352,1322653358,8,6
9945,1322653871,1322653877,1322653883,6,6
9946,1322654872,1322654882,1322654888,10,6
9947,1322655135,1322655137,1322655143,2,6
9948,1322655733,1322655737,1322655744,4,7
9950,1322655946,1322655947,1322655951,1,4
9949,1322655935,1322655947,1322655953,12,6
9951,1322656116,1322656127,1322656131,11,4
9952,1322657632,1322657642,1322657644,10,2
9953,1322657704,1322657717,1322657720,13,3
9954,1322657708,1322657717,1322657720,9,3
9955,1322657712,1322657717,1322657720,5,3
9956,1322657785,1322657792,1322657795,7,3
9957,1322657788,1322657792,1322657796,4,4
9958,1322657791,1322657792,1322657796,1,4
9959,1322657794,1322657807,1322657811,13,4
9960,1322658047,1322658062,1322658068,15,6
9961,1322658368,1322658377,1322658381,9,4
9962,1322658372,1322658377,1322658382,5,5
9963,1322658384,1322658392,1322658396,8,4
9965,1322658504,1322658512,1322658517,8,5
9964,1322658496,1322658497,1322658501,1,4
9791,1322421869,1322421879,1322658601,10,236722
9966,1322658591,1322658602,1322658607,11,5
9967,1322658682,1322658692,1322658696,10,4
9968,1322658825,1322658827,1322658831,2,4
9969,1322659365,1322659367,1322659376,2,9
9970,1322659479,1322659487,1322659491,8,4
9971,1322660752,1322660762,1322660768,10,6
9972,1322660859,1322660867,1322660873,8,6
9973,1322661788,1322661797,1322661803,9,6
9974,1322663542,1322663552,1322663556,10,4
9975,1322663546,1322663552,1322663557,6,5
9976,1322667170,1322667182,1322667183,12,1
9977,1322667173,1322667182,1322667183,9,1
9979,1322667183,1322667197,1322667198,14,1
9984,1322667199,1322667212,1322667212,13,0
9985,1322667202,1322667212,1322667212,10,0
9986,1322667205,1322667212,1322667213,7,1
9987,1322667208,1322667212,1322667213,4,1
9681,1322122881,1322122884,1322667602,3,544718
10008,1322668395,1322668397,1322668397,2,0
10007,1322668382,1322668397,1322668398,15,1
10009,1322668399,1322668412,1322668413,13,1
10010,1322668401,1322668412,1322668413,11,1
10013,1322668410,1322668427,1322668427,17,0
10014,1322668413,1322668427,1322668428,14,1
10011,1322668404,1322668412,1322668412,8,0
10012,1322668407,1322668412,1322668412,5,0
10015,1322668416,1322668472,1322668473,56,1
10016,1322668418,1322668472,1322668473,54,1
10017,1322668421,1322668472,1322668472,51,0
10018,1322668424,1322668472,1322668473,48,1
9993,1322667342,1322667347,1322669683,5,2336
10006,1322668379,1322668382,1322669878,3,1496
10004,1322668373,1322668382,1322669875,9,1493
10001,1322668361,1322668367,1322669871,6,1504
10003,1322668367,1322668382,1322669912,15,1530
10002,1322668364,1322668367,1322669906,3,1539
10005,1322668376,1322668382,1322669943,6,1561
9992,1322667326,1322667332,1322671347,6,4015
9983,1322667195,1322667197,1322671669,2,4472
9999,1322667489,1322667497,1322672977,8,5480
9982,1322667192,1322667197,1322673178,5,5981
9998,1322667486,1322667497,1322673877,11,6380
9989,1322667254,1322667257,1322674021,3,6764
10000,1322667491,1322667497,1322674751,6,7254
10031,1322670050,1322670062,1322676490,12,6428
10034,1322670059,1322673017,1322677195,2958,4178
10033,1322670056,1322671697,1322677294,1641,5597
9990,1322667285,1322667287,1322677599,2,10312
10035,1322670062,1322673212,1322677619,3150,4407
10029,1322670044,1322670047,1322677725,3,7678
10036,1322670065,1322673902,1322677787,3837,3885
10028,1322670040,1322670047,1322678185,7,8138
9994,1322667467,1322667482,1322678239,15,10757
10030,1322670047,1322670062,1322678241,15,8179
10020,1322670016,1322670017,1322678319,1,8302
9988,1322667251,1322667257,1322678439,6,11182
10019,1322670013,1322670017,1322678569,4,8552
10037,1322678601,1322678612,1322678640,11,28
10038,1322678614,1322678627,1322678630,13,3
9991,1322667302,1322667317,1322678944,15,11627
10039,1322678765,1322678777,1322678974,12,197
9981,1322667189,1322667197,1322680123,8,12926
9980,1322667187,1322667197,1322680168,10,12971
10026,1322670034,1322670047,1322681152,13,11105
10045,1322680395,1322680397,1322683249,2,2852
10057,1322680454,1322680457,1322683269,3,2812
9978,1322667179,1322667182,1322683659,3,16477
10027,1322670037,1322670047,1322684193,10,14146
9995,1322667475,1322667482,1322685340,7,17858
10044,1322680391,1322680397,1322685528,6,5131
10056,1322680451,1322680457,1322685719,6,5262
10055,1322680447,1322680457,1322685742,10,5285
10050,1322680420,1322680427,1322685787,7,5360
9997,1322667483,1322667497,1322685906,14,18409
10040,1322680378,1322680382,1322686270,4,5888
10049,1322680417,1322680427,1322686780,10,6353
10024,1322670028,1322670032,1322687496,4,17464
10058,1322680724,1322681177,1322687739,453,6562
10052,1322680434,1322680442,1322687798,8,7356
10051,1322680425,1322680427,1322687861,2,7434
10032,1322670053,1322671397,1322688288,1344,16891
9713,1322145377,1322145459,1322689108,82,543649
10062,1322680740,1322684222,1322689383,3482,5161
10069,1322681394,1322686292,1322690402,4898,4110
10043,1322680388,1322680397,1322690720,9,10323
10061,1322680736,1322683697,1322690939,2961,7242
10041,1322680381,1322680382,1322691588,1,11206
10068,1322681392,1322685932,1322691986,4540,6054
10021,1322670019,1322670032,1322693011,13,22979
10063,1322680743,1322685362,1322693029,4619,7667
10054,1322680441,1322680442,1322693590,1,13148
10064,1322681377,1322685557,1322693984,4180,8427
10088,1322683023,1322694002,1322694030,10979,28
10089,1322683026,1322694077,1322694104,11051,27
10090,1322683028,1322694122,1322694148,11094,26
10091,1322683031,1322694197,1322694225,11166,28
10092,1322683034,1322694242,1322694266,11208,24
10093,1322683038,1322694317,1322694345,11279,28
10053,1322680437,1322680442,1322694402,5,13960
10094,1322683041,1322694362,1322694390,11321,28
10095,1322683125,1322694422,1322694458,11297,36
10096,1322683128,1322694437,1322694474,11309,37
10097,1322683131,1322694497,1322694540,11366,43
10098,1322683134,1322694512,1322694548,11378,36
10099,1322683138,1322694572,1322694603,11434,31
10100,1322683141,1322694602,1322694640,11461,38
10101,1322683144,1322694617,1322694653,11473,36
10102,1322683311,1322694677,1322694705,11366,28
10103,1322683314,1322694692,1322694722,11378,30
10067,1322681388,1322685827,1322694733,4439,8906
10104,1322683317,1322694722,1322694748,11405,26
10105,1322683320,1322694737,1322694772,11417,35
10106,1322683323,1322694752,1322694784,11429,32
10107,1322683326,1322694797,1322694824,11471,27
10108,1322683329,1322694812,1322694839,11483,27
10080,1322681440,1322690417,1322695562,8977,5145
10070,1322681405,1322686832,1322695574,5427,8742
10073,1322681415,1322687822,1322695934,6407,8112
10059,1322680729,1322683277,1322696392,2548,13115
10060,1322680733,1322683292,1322696871,2559,13579
10048,1322680414,1322680427,1322696937,13,16510
10087,1322681467,1322693612,1322697454,12145,3842
10079,1322681437,1322689427,1322697587,7990,8160
10076,1322681428,1322689127,1322698094,7699,8967
10046,1322680408,1322680412,1322698439,4,18027
10081,1322681444,1322690747,1322698907,9303,8160
10072,1322681411,1322687777,1322699116,6366,11339
10066,1322681384,1322685782,1322699239,4398,13457
10042,1322680385,1322680397,1322700499,12,20102
10075,1322681421,1322688317,1322701400,6896,13083
10082,1322681451,1322690972,1322701423,9521,10451
10065,1322681380,1322685737,1322701556,4357,15819
10071,1322681408,1322687507,1322703131,6099,15624
10078,1322681434,1322689127,1322703386,7693,14259
10025,1322670032,1322670047,1322703455,15,33408
9996,1322667478,1322667482,1322704244,4,36762
10084,1322681458,1322692022,1322704735,10564,12713
10074,1322681418,1322687897,1322705043,6479,17146
10083,1322681454,1322691617,1322705172,10163,13555
10077,1322681431,1322689127,1322705705,7696,16578
10086,1322681464,1322693042,1322707161,11578,14119
10047,1322680411,1322680412,1322707427,1,27015
10023,1322670025,1322670032,1322707430,7,37398
10085,1322681461,1322693027,1322717142,11566,24115
10022,1322670022,1322670032,1322719407,10,49375
9889,1322560078,1322560089,1322727455,11,167366
10109,1322729085,1322729087,1322729120,2,33
10112,1322732736,1322732747,1322732758,11,11
10114,1322733271,1322733272,1322733304,1,32
10110,1322729143,1322729147,1322733663,4,4516
10117,1322735457,1322735462,1322735463,5,1
10118,1322735504,1322735507,1322735526,3,19
10121,1322747331,1322747342,1322747344,11,2
10120,1322747324,1322747327,1322747329,3,2
10122,1322748547,1322748557,1322748563,10,6
10123,1322749860,1322749862,1322749868,2,6
10124,1322750277,1322750282,1322750287,5,5
10125,1322750503,1322750507,1322750513,4,6
10126,1322751397,1322751407,1322751413,10,6
10127,1322752688,1322752697,1322752702,9,5
10128,1322753425,1322753432,1322753439,7,7
10129,1322753626,1322753627,1322753630,1,3
10130,1322753689,1322753702,1322753705,13,3
10131,1322753770,1322753777,1322753801,7,24
10132,1322753830,1322753837,1322753841,7,4
10133,1322753847,1322753852,1322753856,5,4
10134,1322753982,1322753987,1322753993,5,6
10135,1322754049,1322754062,1322754068,13,6
10136,1322754150,1322754152,1322754158,2,6
10137,1322754213,1322754227,1322754233,14,6
10138,1322754264,1322754272,1322754278,8,6
10139,1322754299,1322754302,1322754308,3,6
10140,1322754351,1322754362,1322754367,11,5
10141,1322754400,1322754407,1322754410,7,3
10142,1322754495,1322754497,1322754503,2,6
10143,1322754772,1322754782,1322754792,10,10
10144,1322754998,1322755007,1322755014,9,7
10145,1322755059,1322755067,1322755069,8,2
10146,1322755129,1322755142,1322755145,13,3
10147,1322755216,1322755217,1322755220,1,3
10148,1322755332,1322755337,1322755339,5,2
10113,1322732876,1322732882,1322755447,6,22565
10149,1322755436,1322755442,1322755448,6,6
10150,1322755575,1322755577,1322755582,2,5
10151,1322755829,1322755832,1322755846,3,14
10152,1322755839,1322755847,1322755859,8,12
10115,1322733524,1322733527,1322764192,3,30665
9793,1322423984,1322423994,1322786157,10,362163
10119,1322743527,1322743532,1322789382,5,45850
10153,1322812876,1322812877,1322812901,1,24
10154,1322814609,1322814617,1322814621,8,4
10155,1322815684,1322815697,1322815702,13,5
9649,1322041636,1322069665,1322815734,28029,746069
10156,1322816429,1322816432,1322816438,3,6
10160,1322817169,1322817182,1322817188,13,6
10161,1322817512,1322817527,1322817533,15,6
10162,1322818110,1322818112,1322818117,2,5
10163,1322820424,1322820437,1322820443,13,6
10164,1322820501,1322820512,1322820518,11,6
10165,1322820591,1322820602,1322820607,11,5
9700,1322133774,1322135364,1322824691,1590,689327
10167,1322827672,1322827682,1322827688,10,6
10168,1322828891,1322828897,1322829231,6,334
10169,1322831688,1322831702,1322831703,14,1
10170,1322831737,1322831747,1322831749,10,2
10171,1322831797,1322831807,1322831813,10,6
10172,1322831848,1322831852,1322831906,4,54
10173,1322832497,1322832512,1322832574,15,62
10174,1322832912,1322832917,1322832923,5,6
10175,1322835029,1322835032,1322835038,3,6
10176,1322835193,1322835197,1322835202,4,5
9792,1322422563,1322422569,1322838945,6,416376
10177,1322844532,1322844542,1322844543,10,1
10178,1322844538,1322844542,1322844583,4,41
10179,1322844596,1322844602,1322844713,6,111
10180,1322844861,1322844872,1322845028,11,156
10181,1322845138,1322845142,1322845279,4,137
9806,1322469183,1322469189,1322848066,6,378877
10166,1322824699,1322824712,1322851242,13,26530
9905,1322570958,1322570972,1322851997,14,281025
9683,1322123377,1322124294,1322853075,917,728781
10111,1322732554,1322732567,1322898829,13,166262
10189,1322910955,1322910962,1322911079,7,117
10196,1322911134,1322911142,1322911313,8,171
10194,1322911058,1322911067,1322911356,9,289
10195,1322911061,1322911067,1322911356,6,289
10192,1322911052,1322911067,1322911376,15,309
10193,1322911056,1322911067,1322911396,11,329
10197,1322911311,1322911322,1322911452,11,130
10190,1322911046,1322911052,1322911759,6,707
10191,1322911049,1322911052,1322911758,3,706
10198,1322921569,1322921582,1322921584,13,2
10199,1322922435,1322922437,1322922440,2,3
10200,1322923081,1322923082,1322923086,1,4
10201,1322923179,1322923187,1322923191,8,4
10202,1322923533,1322923547,1322923550,14,3
10203,1322923812,1322923817,1322923821,5,4
10204,1322924115,1322924117,1322924136,2,19
10205,1322924245,1322924252,1322924256,7,4
10206,1322924729,1322924732,1322924737,3,5
10207,1322924955,1322924957,1322924969,2,12
10208,1322925156,1322925167,1322925197,11,30
10209,1322925388,1322925392,1322925396,4,4
10186,1322907919,1322907932,1322928863,13,20931
10210,1322933599,1322933612,1322933754,13,142
10211,1322934416,1322934422,1322934434,6,12
10212,1322934527,1322934542,1322934575,15,33
10214,1322934818,1322934827,1322934830,9,3
10215,1322934902,1322934917,1322934919,15,2
10216,1322934982,1322934992,1322935013,10,21
10221,1322935139,1322935142,1322935206,3,64
10222,1322935141,1322935142,1322935274,1,132
10219,1322935134,1322935142,1322935375,8,233
10220,1322935137,1322935142,1322935381,5,239
10217,1322935129,1322935142,1322935414,13,272
10218,1322935131,1322935142,1322935395,11,253
10223,1322935143,1322935157,1322935517,14,360
9789,1322404493,1322404494,1322937556,1,533062
10224,1322938385,1322938397,1322938569,12,172
10159,1322816776,1322816777,1322940405,1,123628
10225,1322940492,1322940497,1322940514,5,17
10232,1322940729,1322940737,1322940852,8,115
10226,1322940712,1322940722,1322940884,10,162
10231,1322940726,1322940737,1322940870,11,133
10229,1322940720,1322940722,1322940914,2,192
10230,1322940723,1322940737,1322940925,14,188
10227,1322940715,1322940722,1322941016,7,294
10228,1322940718,1322940722,1322941039,4,317
9710,1322144052,1322147394,1322974837,3342,827443
10185,1322907915,1322907917,1322990092,2,82175
10235,1322996027,1322996042,1322996091,15,49
10234,1322996024,1322996027,1322996166,3,139
10237,1322996189,1322996192,1322996226,3,34
10236,1322996186,1322996192,1322996286,6,94
10238,1322996427,1322996432,1322996468,5,36
10239,1322996525,1322996537,1322996537,12,0
10243,1322996606,1322996612,1322996612,6,0
10244,1322996609,1322996612,1322996612,3,0
10242,1322996602,1322996612,1322996612,10,0
10241,1322996531,1322996537,1322996687,6,150
10247,1322996765,1322996777,1322996793,12,16
10246,1322996763,1322996777,1322996806,14,29
10245,1322996760,1322996762,1322996833,2,71
10248,1322996810,1322996822,1322996832,12,10
10249,1322996849,1322996852,1322996877,3,25
10240,1322996529,1322996537,1322996894,8,357
10251,1322996969,1322996972,1322996983,3,11
10250,1322996946,1322996957,1322996979,11,22
10252,1322997118,1322997122,1322997208,4,86
10253,1322997235,1322997242,1322997264,7,22
10254,1322997816,1322997827,1322997841,11,14
10256,1322997876,1322997887,1322997917,11,30
10258,1322997881,1322997887,1322997901,6,14
10257,1322997879,1322997887,1322997904,8,17
10260,1322997961,1322997962,1322997982,1,20
10259,1322997955,1322997962,1322997984,7,22
10261,1322997973,1322997977,1322997984,4,7
10263,1322998028,1322998037,1322998049,9,12
10262,1322998007,1322998022,1322998030,15,8
10264,1322998081,1322998082,1322998114,1,32
10265,1322998084,1322998097,1322998111,13,14
10266,1322998087,1322998097,1322998106,10,9
10267,1322998090,1322998097,1322998114,7,17
10268,1322998116,1322998127,1322998135,11,8
10255,1322997873,1322997887,1322998169,14,282
10269,1322998142,1322998157,1322998169,15,12
10272,1322998230,1322998232,1322998258,2,26
10273,1322998237,1322998247,1322998268,10,21
10270,1322998224,1322998232,1322998339,8,107
10271,1322998227,1322998232,1322998360,5,128
10274,1322998572,1322998577,1322998613,5,36
10276,1322998710,1322998712,1322998726,2,14
10275,1322998701,1322998712,1322998751,11,39
10279,1322999191,1322999192,1322999223,1,31
10277,1322999186,1322999192,1322999200,6,8
10278,1322999189,1322999192,1322999205,3,13
10280,1322999194,1322999207,1322999243,13,36
10281,1322999235,1322999237,1322999241,2,4
10284,1322999243,1322999252,1322999265,9,13
10282,1322999237,1322999252,1322999261,15,9
10283,1322999240,1322999252,1322999257,12,5
10286,1322999300,1322999312,1322999319,12,7
10285,1322999298,1322999312,1322999315,14,3
10287,1322999303,1322999312,1322999318,9,6
10288,1322999307,1322999312,1322999320,5,8
10289,1322999309,1322999312,1322999321,3,9
10290,1322999312,1322999327,1322999342,15,15
10291,1323000038,1323000047,1323000066,9,19
10292,1323000406,1323000407,1323000413,1,6
10293,1323001920,1323001922,1323001926,2,4
10294,1323001924,1323001938,1323001953,14,15
10295,1323002081,1323002087,1323002087,6,0
10297,1323002219,1323002222,1323002237,3,15
10302,1323002631,1323002642,1323002643,11,1
10296,1323002143,1323002147,1323010419,4,8272
10304,1323002640,1323002642,1323058518,2,55876
10303,1323002634,1323002642,1323060017,8,57375
10301,1323002629,1323002642,1323060263,13,57621
10309,1323002654,1323002657,1323061403,3,58746
10314,1323072713,1323072722,1323072725,9,3
10315,1323072826,1323072827,1323072829,1,2
10327,1323075822,1323075822,1323075826,0,4
9239,1320825943,1320825954,1323075927,11,2249973
9270,1320916190,1320916194,1323075963,4,2159769
10329,1323076050,1323076077,1323076263,27,186
10316,1323072981,1323072992,1323076290,11,3298
10331,1323076260,1323076287,1323076357,27,70
10332,1323076369,1323076392,1323076403,23,11
10333,1323076506,1323076512,1323076541,6,29
9682,1322123176,1322123184,1323076692,8,953508
10336,1323079494,1323079497,1323079497,3,0
10337,1323079525,1323079525,1323079530,0,5
10305,1323002643,1323002657,1323080191,14,77534
10306,1323002646,1323002657,1323083058,11,80401
10339,1323081362,1323083095,1323083095,1733,0
9886,1322554485,1322554494,1323085558,9,531064
10340,1323086978,1323086980,1323086985,2,5
10318,1323074748,1323074762,1323087137,14,12375
10343,1323087153,1323087160,1323087165,7,5
10320,1323074832,1323074837,1323087192,5,12355
10310,1323002657,1323002672,1323087271,15,84599
10311,1323002659,1323002672,1323087304,13,84632
10347,1323089484,1323089485,1323089490,1,5
10350,1323093537,1323093550,1323093587,13,37
10354,1323094649,1323094660,1323094693,11,33
10356,1323095393,1323095395,1323095396,2,1
10357,1323095470,1323095485,1323095491,15,6
10358,1323095537,1323095545,1323095577,8,32
10359,1323096277,1323096280,1323096285,3,5
10360,1323096470,1323096475,1323096476,5,1
10361,1323097232,1323097240,1323097255,8,15
10363,1323097240,1323097255,1323097275,15,20
10364,1323097245,1323097255,1323097268,10,13
10365,1323097249,1323097255,1323097265,6,10
10362,1323097236,1323097240,1323097283,4,43
10366,1323097253,1323097255,1323097340,2,85
10367,1323097451,1323097465,1323097485,14,20
10355,1323094721,1323094735,1323097490,14,2755
10368,1323097506,1323097510,1323097844,4,334
10369,1323097823,1323097825,1323097846,2,21
10371,1323097949,1323097960,1323097979,11,19
10374,1323098673,1323098680,1323098698,7,18
10375,1323098716,1323098725,1323098733,9,8
10373,1323098226,1323098230,1323098760,4,530
10370,1323097890,1323097900,1323098781,10,881
10376,1323098764,1323098770,1323098783,6,13
10377,1323098803,1323098815,1323098830,12,15
10378,1323098846,1323098860,1323098865,14,5
10379,1323098894,1323098905,1323098911,11,6
10380,1323099506,1323099520,1323099543,14,23
10381,1323099561,1323099565,1323099590,4,25
10353,1323094503,1323094510,1323100820,7,6310
10323,1323074973,1323074987,1323100883,14,25896
10372,1323097990,1323098005,1323101065,15,3060
10321,1323074881,1323074882,1323102419,1,27537
10351,1323093686,1323093700,1323102660,14,8960
10319,1323074792,1323074807,1323102737,15,27930
10324,1323075021,1323075032,1323104033,11,29001
10385,1323104953,1323104965,1323105411,12,446
10388,1323106195,1323106210,1323106211,15,1
10322,1323074924,1323074927,1323107012,3,32085
10389,1323109206,1323109210,1323109230,4,20
10390,1323109322,1323109330,1323109339,8,9
10391,1323109542,1323109555,1323109558,13,3
10392,1323109656,1323109660,1323109673,4,13
10393,1323110614,1323110620,1323110645,6,25
10300,1323002626,1323002627,1323116231,1,113604
10384,1323104595,1323104605,1323119452,10,14847
10344,1323087160,1323087175,1323143058,15,55883
10394,1323110666,1323110680,1323144466,14,33786
10383,1323100108,1323100120,1323146943,12,46823
10386,1323105461,1323105476,1323147772,15,42296
10312,1323023610,1323023612,1323153544,2,129932
10342,1323087095,1323087100,1323155378,5,68278
10387,1323105766,1323105775,1323157383,9,51608
10395,1323159748,1323159760,1323159762,12,2
10397,1323160643,1323160645,1323160646,2,1
10398,1323160819,1323160825,1323160826,6,1
10400,1323161356,1323161365,1323161381,9,16
10317,1323074118,1323074132,1323162272,14,88140
10298,1323002621,1323002627,1323165415,6,162788
10299,1323002624,1323002627,1323165438,3,162811
10407,1323165654,1323165655,1323165661,1,6
10307,1323002648,1323002657,1323166025,9,163368
10410,1323166128,1323166135,1323166140,7,5
10413,1323169844,1323169855,1323169855,11,0
10414,1323169846,1323169855,1323169856,9,1
10399,1323161171,1323161185,1323169941,14,8756
10417,1323173187,1323173200,1323173205,13,5
10418,1323173321,1323173335,1323173340,14,5
10421,1323181811,1323181825,1323181829,14,4
10422,1323181983,1323181990,1323181995,7,5
10423,1323182083,1323182095,1323182101,12,6
10424,1323182158,1323182170,1323182175,12,5
10425,1323182284,1323182290,1323182295,6,5
10426,1323182452,1323182455,1323182460,3,5
10427,1323183101,1323183115,1323183120,14,5
10428,1323183385,1323183400,1323183405,15,5
10429,1323183580,1323183595,1323183600,15,5
10430,1323184078,1323184090,1323184095,12,5
10431,1323184083,1323184090,1323184095,7,5
10432,1323184091,1323184105,1323184111,14,6
10433,1323184225,1323184240,1323184250,15,10
10434,1323184698,1323184705,1323184710,7,5
10435,1323184829,1323184840,1323184845,11,5
10436,1323185133,1323185140,1323185145,7,5
10437,1323185568,1323185575,1323185581,7,6
10438,1323187059,1323187060,1323187067,1,7
10439,1323187250,1323187255,1323187266,5,11
9511,1321552447,1321560309,1323212458,7862,1652149
10404,1323162746,1323162760,1323212576,14,49816
10415,1323169958,1323169960,1323214480,2,44520
10406,1323165634,1323165640,1323217951,6,52311
10419,1323177674,1323177685,1323220295,11,42610
10403,1323162624,1323162626,1323225168,2,62542
10308,1323002652,1323002657,1323225804,5,223147
10187,1322908082,1322908097,1323228850,15,320753
9920,1322637179,1322637182,1323229974,3,592792
10346,1323087334,1323087340,1323236451,6,149111
9790,1322419262,1322419269,1323245366,7,826097
10416,1323169961,1323169975,1323246162,14,76187
10158,1322816690,1322816702,1323246442,12,429740
10443,1323246463,1323246477,1323246478,14,1
10184,1322907508,1322907512,1323246510,4,338998
10446,1323246592,1323246595,1323246595,3,0
9782,1322315606,1322315619,1323247320,13,931701
10449,1323248553,1323248561,1323248601,8,40
10382,1323099602,1323099610,1323248635,8,149025
10450,1323248629,1323248635,1323248791,6,156
10451,1323248806,1323248815,1323248848,9,33
10441,1323245764,1323245770,1323249591,6,3821
10453,1323251083,1323251095,1323251102,12,7
10454,1323252906,1323252910,1323252915,4,5
10455,1323252916,1323252925,1323252931,9,6
10456,1323254619,1323254620,1323254625,1,5
10457,1323255110,1323255115,1323255120,5,5
10458,1323257006,1323257020,1323257025,14,5
10459,1323266259,1323266260,1323266266,1,6
10116,1322733716,1322733722,1323268120,6,534398
10460,1323272166,1323272170,1323272175,4,5
10461,1323272360,1323272365,1323272371,5,6
9890,1322560360,1322560374,1323282849,14,722475
10345,1323087218,1323087220,1323303074,2,215854
10188,1322908253,1323247360,1323310604,339107,63244
10462,1323333112,1323333115,1323333120,3,5
10463,1323334742,1323334750,1323334755,8,5
10464,1323335765,1323335770,1323335776,5,6
10465,1323336005,1323336010,1323336015,5,5
10466,1323337351,1323337360,1323337365,9,5
10467,1323337681,1323337690,1323337695,9,5
10468,1323337805,1323337810,1323337815,5,5
10469,1323338090,1323338095,1323338100,5,5
10313,1323069907,1323069917,1323342395,10,272478
10470,1323343714,1323343720,1323343854,6,134
10471,1323344072,1323344080,1323344112,8,32
10473,1323344310,1323344320,1323344326,10,6
10472,1323344148,1323344155,1323345392,7,1237
10411,1323166186,1323166195,1323345985,9,179790
10479,1323347716,1323347725,1323347730,9,5
10480,1323348159,1323348160,1323348165,1,5
10481,1323348257,1323348265,1323348270,8,5
10482,1323348718,1323348730,1323348733,12,3
10483,1323348819,1323348820,1323348827,1,7
10484,1323349438,1323349450,1323349457,12,7
10485,1323350563,1323350575,1323350580,12,5
10486,1323350662,1323350665,1323350675,3,10
10487,1323350986,1323350995,1323350998,9,3
10488,1323351179,1323351190,1323351196,11,6
10489,1323351255,1323351265,1323351270,10,5
10490,1323352245,1323352255,1323352262,10,7
10491,1323352544,1323352555,1323352561,11,6
10492,1323356457,1323356470,1323356475,13,5
10493,1323357305,1323357310,1323357315,5,5
10494,1323357458,1323357460,1323357465,2,5
10495,1323358487,1323358495,1323358500,8,5
10182,1322859933,1322859947,1323359649,14,499702
10478,1323346296,1323346300,1323364359,4,18059
10497,1323365774,1323365785,1323366188,11,403
10477,1323346266,1323346270,1323367028,4,20758
10409,1323166119,1323166120,1323368567,1,202447
10498,1323366206,1323366220,1323368930,14,2710
10475,1323346186,1323346195,1323379957,9,33762
10474,1323346129,1323346135,1323391013,6,44878
10328,1323075854,1323075867,1323400630,13,324763
10349,1323093304,1323093310,1323403304,6,309994
10496,1323363433,1323363446,1323414337,13,50891
10499,1323415670,1323415675,1323416132,5,457
9626,1321966443,1321979709,1323416938,13266,1437229
10442,1323246173,1323246175,1323417370,2,171195
10476,1323346227,1323346240,1323421080,13,74840
10405,1323163131,1323163135,1323428353,4,265218
10503,1323420990,1323421000,1323430699,10,9699
10507,1323434433,1323434440,1323434446,7,6
10508,1323435103,1323435115,1323435121,12,6
10509,1323435580,1323435595,1323435608,15,13
10510,1323435586,1323435595,1323435608,9,13
10511,1323435879,1323435880,1323435885,1,5
10512,1323438431,1323438445,1323438450,14,5
10516,1323439753,1323439765,1323439783,12,18
10501,1323418585,1323418600,1323439896,15,21296
10502,1323418823,1323418825,1323440021,2,21196
10519,1323440015,1323440020,1323440031,5,11
10521,1323440778,1323440785,1323440791,7,6
10522,1323440814,1323440815,1323440952,1,137
10523,1323441139,1323441145,1323441145,6,0
10524,1323441200,1323441205,1323441265,5,60
10506,1323432480,1323432490,1323448616,10,16126
10505,1323431114,1323431125,1323449281,11,18156
9602,1321962840,1321962849,1323451452,9,1488603
10500,1323417386,1323417400,1323455233,14,37833
10525,1323445175,1323445180,1323485380,5,40200
10504,1323430025,1323430031,1323492612,6,62581
10527,1323446180,1323446185,1323497451,5,51266
10326,1323075563,1323075573,1323512623,10,437050
10531,1323503005,1323503020,1323540899,15,37879
10513,1323439518,1323439525,1323542994,7,103469
10540,1323546385,1323546400,1323549218,15,2818
10535,1323546366,1323546370,1323549337,4,2967
10408,1323166038,1323166045,1323551870,7,385825
10541,1323546388,1323546400,1323552891,12,6491
10538,1323546376,1323546385,1323553835,9,7450
10537,1323546373,1323546385,1323553923,12,7538
10536,1323546369,1323546370,1323554096,1,7726
10539,1323546382,1323546385,1323554100,3,7715
10543,1323546398,1323549265,1323556115,2867,6850
10544,1323546401,1323549385,1323557358,2984,7973
10546,1323546418,1323552910,1323558497,6492,5587
10551,1323546646,1323556135,1323560427,9489,4292
10401,1323161393,1323161395,1323561291,2,399896
10552,1323546648,1323557380,1323562018,10732,4638
10553,1323546652,1323558520,1323562153,11868,3633
10554,1323546655,1323560455,1323564839,13800,4384
10563,1323560130,1323560140,1323565518,10,5378
10548,1323546637,1323553945,1323566735,7308,12790
10549,1323546640,1323554110,1323567060,7470,12950
10550,1323546643,1323554140,1323567197,7497,13057
10542,1323546395,1323546400,1323569145,5,22745
10557,1323546664,1323562195,1323574214,15531,12019
10545,1323546407,1323551905,1323574622,5498,22717
10547,1323546420,1323553855,1323576645,7435,22790
10555,1323546658,1323561385,1323577427,14727,16042
10558,1323546667,1323564865,1323578952,18198,14087
10528,1323455451,1323455455,1323580498,4,125043
10556,1323546661,1323562060,1323586254,15399,24194
10564,1323590204,1323590215,1323590242,11,27
10566,1323590715,1323590725,1323601495,10,10770
10567,1323594155,1323594160,1323601887,5,7727
10517,1323439795,1323439810,1323605890,15,166080
10518,1323439872,1323439887,1323606856,15,166969
10568,1323602455,1323602470,1323613225,15,10755
10559,1323546670,1323566785,1323625352,20115,58567
10452,1323248902,1323248905,1323641148,3,392243
10530,1323502650,1323502660,1323654785,10,152125
10514,1323439636,1323439645,1323663153,9,223508
10560,1323546673,1323567070,1323678228,20397,111158
10561,1323546676,1323567220,1323680011,20544,112791
10573,1323683290,1323683305,1323683311,15,6
10572,1323683286,1323683290,1323683298,4,8
10577,1323683307,1323683320,1323683335,13,15
10578,1323683310,1323683320,1323683341,10,21
10574,1323683295,1323683305,1323683322,10,17
10575,1323683300,1323683305,1323683323,5,18
10576,1323683304,1323683305,1323683323,1,18
10579,1323683312,1323683320,1323683342,8,22
10580,1323683316,1323683320,1323683348,4,28
10581,1323683318,1323683320,1323683350,2,30
10584,1323687399,1323687400,1323687428,1,28
10585,1323687443,1323687445,1323687460,2,15
10515,1323439700,1323439705,1323688540,5,248835
10570,1323605704,1323605710,1323689077,6,83367
10571,1323605826,1323605833,1323689077,7,83244
10592,1323691152,1323691165,1323691199,13,34
10582,1323686060,1323686065,1323693911,5,7846
10593,1323693936,1323693940,1323693971,4,31
10591,1323690218,1323690220,1323694191,2,3971
10596,1323694331,1323694345,1323694367,14,22
10598,1323694389,1323694390,1323694416,1,26
10599,1323694456,1323694465,1323695351,9,886
10600,1323695576,1323695590,1323695640,14,50
10601,1323696406,1323696415,1323696446,9,31
10602,1323697050,1323697060,1323697763,10,703
10604,1323698338,1323698350,1323698377,12,27
10606,1323700426,1323700435,1323700440,9,5
10607,1323700454,1323700465,1323700472,11,7
10588,1323689271,1323689275,1323703601,4,14326
10609,1323705272,1323705280,1323705284,8,4
10590,1323689427,1323689440,1323705416,13,15976
10529,1323502646,1323502660,1323706344,14,203684
10610,1323705342,1323705355,1323706974,13,1619
10612,1323708397,1323708400,1323709159,3,759
10615,1323709330,1323709345,1323709346,15,1
10617,1323709913,1323709915,1323709916,2,1
10611,1323707316,1323707320,1323710676,4,3356
10616,1323709359,1323709360,1323711415,1,2055
10619,1323711628,1323711640,1323711641,12,1
10620,1323711687,1323711700,1323711702,13,2
10621,1323711750,1323711760,1323711793,10,33
10520,1323440052,1323440065,1323711850,13,271785
10597,1323694348,1323706375,1323716215,12027,9840
8118,1317813292,1317813296,1323722248,4,5908952
10325,1323075394,1323075410,1323722746,16,647336
10533,1323503900,1323503905,1323739592,5,235687
10586,1323688325,1323688330,1323739824,5,51494
10589,1323689306,1323689320,1323760793,14,71473
10622,1323765854,1323765865,1323765870,11,5
10623,1323767870,1323767875,1323767881,5,6
10587,1323688332,1323688345,1323768474,13,80129
10625,1323768853,1323768865,1323768871,12,6
10626,1323768858,1323768865,1323768871,7,6
10627,1323768860,1323768865,1323768871,5,6
10628,1323768863,1323768865,1323768871,2,6
10629,1323769655,1323769660,1323769661,5,1
10630,1323769722,1323769736,1323769886,14,150
10631,1323770206,1323770215,1323770379,9,164
10633,1323772119,1323772120,1323772122,1,2
10634,1323772192,1323772195,1323772196,3,1
10635,1323772268,1323772270,1323772308,2,38
10636,1323772471,1323772480,1323772506,9,26
10637,1323772544,1323772555,1323772556,11,1
10618,1323709990,1323710005,1323772560,15,62555
10638,1323772602,1323772615,1323772648,13,33
10639,1323772883,1323772885,1323772890,2,5
10640,1323773158,1323773170,1323773175,12,5
10641,1323773918,1323773920,1323774479,2,559
10643,1323775242,1323775255,1323775257,13,2
10330,1323076168,1323102745,1323775977,26577,673232
10644,1323776254,1323776260,1323776266,6,6
10645,1323777102,1323777115,1323777117,13,2
10605,1323700166,1323700180,1323778952,14,78772
10647,1323778961,1323778975,1323779087,14,112
10649,1323779172,1323779185,1323779605,13,420
10646,1323777231,1323777235,1323779789,4,2554
10650,1323780571,1323780580,1323780652,9,72
10651,1323780732,1323780745,1323780751,13,6
10653,1323780820,1323780835,1323780840,15,5
10652,1323780800,1323780805,1323780961,5,156
10654,1323781267,1323781270,1323783180,3,1910
10655,1323783624,1323783625,1323783973,1,348
10648,1323779053,1323779065,1323784089,12,5024
10656,1323784696,1323784705,1323784708,9,3
10657,1323784937,1323784945,1323784949,8,4
10658,1323785582,1323785590,1323785754,8,164
10659,1323787846,1323787855,1323787860,9,5
10660,1323788396,1323788410,1323788729,14,319
10420,1323178938,1323212500,1323788740,33562,576240
10396,1323159840,1323159850,1323789392,10,629542
10662,1323790132,1323790135,1323790141,3,6
10663,1323790189,1323790195,1323790198,6,3
10664,1323790315,1323790330,1323790400,15,70
10661,1323788677,1323788680,1323791710,3,3030
10594,1323694205,1323694210,1323799816,5,105606
10440,1323245703,1323245710,1323814784,7,569074
10534,1323503903,1323503905,1323833855,2,329950
10565,1323590635,1323590650,1323852055,15,261405
9699,1322133456,1322145459,1323853943,12003,1708484
10671,1323854120,1323854125,1323854129,5,4
10672,1323855035,1323855040,1323855045,5,5
10673,1323856025,1323856030,1323856033,5,3
10674,1323858270,1323858280,1323858283,10,3
10675,1323858396,1323858400,1323858404,4,4
10676,1323858554,1323858565,1323858568,11,3
10677,1323858659,1323858670,1323858673,11,3
10678,1323858752,1323858760,1323858763,8,3
10679,1323858850,1323858865,1323858868,15,3
10680,1323858882,1323858895,1323858898,13,3
10681,1323858935,1323858940,1323858944,5,4
10682,1323859158,1323859165,1323859168,7,3
10683,1323859203,1323859210,1323859227,7,17
10684,1323859256,1323859270,1323859274,14,4
10685,1323859458,1323859465,1323859469,7,4
10686,1323859517,1323859525,1323859529,8,4
10687,1323859621,1323859630,1323859632,9,2
10688,1323860149,1323860155,1323860161,6,6
10689,1323860401,1323860410,1323860416,9,6
10690,1323860504,1323860515,1323860519,11,4
10691,1323861232,1323861235,1323861243,3,8
10692,1323861267,1323861280,1323861288,13,8
10693,1323861383,1323861385,1323861385,2,0
10694,1323862877,1323862885,1323862893,8,8
10695,1323866690,1323866695,1323866701,5,6
10696,1323868266,1323868270,1323868276,4,6
10697,1323869117,1323869125,1323869130,8,5
10698,1323869612,1323869620,1323869623,8,3
10699,1323870452,1323870460,1323870463,8,3
10700,1323873045,1323873055,1323873059,10,4
10642,1323774218,1323774220,1323890947,2,116727
8258,1318518533,1318518536,1323923865,3,5405329
10569,1323603811,1323603820,1323927498,9,323678
10595,1323694232,1323694240,1323932423,8,238183
10701,1323936248,1323936250,1323936280,2,30
10704,1323946426,1323946435,1323946456,9,21
10707,1323946447,1323946450,1323946465,3,15
10710,1323946457,1323946465,1323946467,8,2
10709,1323946453,1323946465,1323946467,12,2
10711,1323946597,1323946600,1323946604,3,4
10705,1323946434,1323946435,1323946745,1,310
10708,1323946450,1323946465,1323947188,15,723
10706,1323946442,1323946450,1323947556,8,1106
10712,1323948363,1323948370,1323948374,7,4
10713,1323948557,1323948565,1323948568,8,3
10714,1323948710,1323948715,1323948719,5,4
10715,1323948890,1323948895,1323948902,5,7
10716,1323949259,1323949270,1323949274,11,4
10717,1323949393,1323949405,1323949539,12,134
10669,1323853761,1323853765,1323950028,4,96263
10718,1323953958,1323953965,1323953993,7,28
10719,1323955242,1323955255,1323955282,13,27
10720,1323955306,1323955315,1323955321,9,6
10721,1323957225,1323957235,1323957242,10,7
10722,1323957300,1323957310,1323957314,10,4
10723,1323962829,1323962830,1323962833,1,3
10727,1323962952,1323962965,1323962967,13,2
10724,1323962930,1323962935,1323962938,5,3
10725,1323962943,1323962950,1323962953,7,3
10726,1323962947,1323962950,1323962953,3,3
10735,1323963186,1323963190,1323963193,4,3
10733,1323963167,1323963175,1323963178,8,3
10734,1323963172,1323963175,1323963178,3,3
10730,1323963147,1323963160,1323963162,13,2
10731,1323963154,1323963160,1323963162,6,2
10732,1323963159,1323963160,1323963163,1,3
10736,1323963519,1323963520,1323963523,1,3
10738,1323963526,1323963535,1323963538,9,3
10739,1323963533,1323963535,1323963537,2,2
10740,1323963538,1323963550,1323963553,12,3
10737,1323963522,1323963535,1323963612,13,77
10742,1323964064,1323964075,1323964078,11,3
10743,1323964112,1323964120,1323964123,8,3
10744,1323964370,1323964375,1323964377,5,2
10745,1323964374,1323964375,1323964378,1,3
10746,1323964379,1323964390,1323964393,11,3
10747,1323964382,1323964390,1323964393,8,3
10748,1323964385,1323964390,1323964393,5,3
10749,1323966469,1323966475,1323966478,6,3
10741,1323963804,1323963805,1323975562,1,11757
10665,1323790434,1323790435,1324006792,1,216357
10750,1323968221,1323968230,1324007134,9,38904
10624,1323768297,1323768310,1324009702,13,241392
9207,1320605335,1320605349,1324016141,14,3410792
10670,1323853781,1323853795,1324033539,14,179744
10703,1323938639,1323938650,1324035930,11,97280
10751,1324037485,1324037500,1324037504,15,4
10668,1323852607,1323852610,1324068327,3,215717
10444,1323246525,1323246535,1324131898,10,885363
10157,1322816458,1322816462,1324134387,4,1317925
10755,1324141177,1324141180,1324146886,3,5706
10532,1323503326,1323503335,1324170896,9,667561
10335,1323077843,1323077847,1324189963,4,1112116
10729,1323963109,1323963116,1324196748,7,233632
10756,1324197507,1324197520,1324199347,13,1827
10754,1324140883,1324140895,1324225340,12,84445
10583,1323686271,1324134400,1324242258,448129,107858
10603,1323697936,1323697945,1324243496,9,545551
10761,1324222957,1324222961,1324249085,4,26124
10762,1324223129,1324223140,1324255156,11,32016
10757,1324218397,1324218400,1324268121,3,49721
10775,1324292227,1324292230,1324292257,3,27
10769,1324291163,1324291165,1324293262,2,2097
10766,1324291009,1324291015,1324293702,6,2687
10765,1324290968,1324290970,1324294042,2,3072
10772,1324291302,1324291315,1324294079,13,2764
10771,1324291259,1324291270,1324297348,11,6078
10770,1324291205,1324291210,1324297441,5,6231
10776,1324301777,1324301785,1324301790,8,5
10777,1324301882,1324301890,1324301893,8,3
10778,1324302193,1324302205,1324302212,12,7
10779,1324303485,1324303495,1324303498,10,3
10780,1324303592,1324303602,1324303605,10,3
10781,1324303753,1324303765,1324303771,12,6
10782,1324304218,1324304230,1324304235,12,5
10783,1324304309,1324304320,1324304323,11,3
10784,1324304810,1324304815,1324304820,5,5
10785,1324304861,1324304875,1324304878,14,3
10786,1324304930,1324304936,1324304942,6,6
10787,1324305206,1324305220,1324305225,14,5
10788,1324305895,1324305910,1324305915,15,5
10789,1324306175,1324306180,1324306185,5,5
10790,1324310107,1324310110,1324310116,3,6
10767,1324291054,1324291060,1324311247,6,20187
10774,1324292205,1324292215,1324311917,10,19702
10768,1324291130,1324291135,1324325006,5,33871
10608,1323702056,1323702070,1324325117,14,623047
10764,1324290930,1324290940,1324325983,10,35043
10763,1324290927,1324290940,1324327850,13,36910
10338,1323080836,1323080845,1324347336,9,1266491
10667,1323852292,1324242295,1324349464,390003,107169
10791,1324374965,1324374970,1324374975,5,5
10792,1324374974,1324374985,1324374991,11,6
10759,1324219593,1324219600,1324394098,7,174498
10341,1323087037,1323087040,1324437701,3,1350661
10773,1324291927,1324291930,1324451148,3,159218
10795,1324465627,1324465630,1324465631,3,1
10796,1324465859,1324465870,1324465871,11,1
10797,1324466219,1324466230,1324466231,11,1
10798,1324466336,1324466350,1324466483,14,133
10799,1324466631,1324466635,1324466767,4,132
10800,1324466876,1324466890,1324466899,14,9
10801,1324467038,1324467040,1324467052,2,12
10802,1324467120,1324467130,1324467348,10,218
10807,1324470801,1324470805,1324470810,4,5
10808,1324472015,1324472020,1324472021,5,1
10811,1324473019,1324473025,1324473031,6,6
10812,1324473885,1324473895,1324473901,10,6
10813,1324474046,1324474060,1324474066,14,6
10814,1324474189,1324474195,1324474201,6,6
10815,1324474399,1324474405,1324474411,6,6
10803,1324467635,1324467640,1324476563,5,8923
10816,1324476562,1324476565,1324476570,3,5
10817,1324476850,1324476865,1324476870,15,5
10818,1324478069,1324478080,1324478086,11,6
10819,1324478314,1324478320,1324478327,6,7
10820,1324479453,1324479460,1324479466,7,6
10760,1324219596,1324219600,1324491350,4,271750
10804,1324467873,1324467880,1324493827,7,25947
10806,1324468627,1324468630,1324500002,3,31372
10809,1324472114,1324472125,1324506277,11,34152
10821,1324542922,1324542926,1324542932,4,6
10822,1324543282,1324543285,1324543291,3,6
10810,1324472297,1324472305,1324548315,8,76010
10829,1324551164,1324551175,1324551175,11,0
10805,1324468129,1324468135,1324565013,6,96878
10830,1324551266,1324551280,1324576039,14,24759
10826,1324550052,1324550065,1324577847,13,27782
10832,1324555179,1324555180,1324581536,1,26356
10831,1324555069,1324555075,1324582220,6,27145
10828,1324551161,1324551175,1324622336,14,71161
10827,1324550123,1324550125,1324624365,2,74240
10839,1324628416,1324628425,1324628425,9,0
10845,1324629410,1324629415,1324629456,5,41
10867,1324630152,1324630166,1324630172,14,6
10868,1324630640,1324630645,1324630651,5,6
10869,1324630780,1324630795,1324630800,15,5
10870,1324630998,1324631005,1324631010,7,5
10871,1324631179,1324631185,1324631190,6,5
10872,1324631445,1324631455,1324631460,10,5
10873,1324632288,1324632295,1324632300,7,5
10874,1324632489,1324632490,1324632495,1,5
10875,1324632734,1324632745,1324632750,11,5
10876,1324634063,1324634065,1324634070,2,5
10877,1324634450,1324634455,1324634460,5,5
10753,1324140816,1324140820,1324646118,4,505298
9877,1322488540,1322488554,1324646607,14,2158053
10837,1324627462,1324627465,1324646787,3,19322
10881,1324653009,1324653010,1324653014,1,4
10882,1324654481,1324654495,1324654500,14,5
10848,1324629475,1324629490,1324655735,15,26245
10842,1324629401,1324629415,1324655739,14,26324
10824,1324549963,1324549975,1324656643,12,106668
10879,1324646629,1324656685,1324656685,10056,0
10843,1324629404,1324629415,1324657601,11,28186
10841,1324628812,1324628815,1324662763,3,33948
10835,1324569890,1324569895,1324664802,5,94907
10864,1324629533,1324629535,1324667240,2,37705
10863,1324629530,1324629535,1324667394,5,37859
10836,1324569897,1324664815,1324667592,94918,2777
10838,1324627808,1324627810,1324669442,2,41632
10840,1324628783,1324628785,1324672199,2,43414
10861,1324629524,1324629535,1324675945,11,46410
10858,1324629514,1324629520,1324678602,6,49082
10866,1324629605,1324646635,1324683111,17030,36476
10865,1324629535,1324646140,1324694495,16605,48355
10825,1324549997,1324656730,1324698250,106733,41520
10862,1324629527,1324629535,1324706121,8,76586
10844,1324629407,1324629415,1324712425,8,83010
10846,1324629415,1324629430,1324715230,15,85800
10847,1324629472,1324629475,1324716489,3,87014
10853,1324629495,1324629505,1324719217,10,89712
10885,1324743061,1324743070,1324743215,9,145
10886,1324743227,1324743235,1324743698,8,463
10887,1324743241,1324743250,1324743746,9,496
10888,1324743432,1324743445,1324743910,13,465
10889,1324743566,1324743580,1324743982,14,402
10860,1324629521,1324629535,1324780697,14,151162
10856,1324629506,1324629520,1324786448,14,156928
10855,1324629503,1324629505,1324786716,2,157211
10857,1324629511,1324629520,1324786719,9,157199
10859,1324629517,1324629520,1324786757,3,157237
10884,1324716899,1324716910,1324795353,11,78443
10883,1324668577,1324668625,1324811849,48,143224
10913,1324812674,1324812687,1324812688,13,1
10914,1324812938,1324812940,1324812941,2,1
10893,1324812621,1324812625,1324813043,4,418
10892,1324812619,1324812625,1324813042,6,417
10894,1324812624,1324812625,1324813044,1,419
10906,1324812653,1324812655,1324813080,2,425
10897,1324812631,1324812640,1324813096,9,456
10912,1324812670,1324812685,1324813144,15,459
10899,1324812636,1324812640,1324813127,4,487
10895,1324812626,1324812640,1324813160,14,520
10891,1324812617,1324812625,1324813145,8,520
10890,1324812614,1324812625,1324813156,11,531
10905,1324812650,1324812655,1324813188,5,533
10904,1324812648,1324812655,1324813186,7,531
10898,1324812633,1324812640,1324813207,7,567
10896,1324812629,1324812640,1324813214,11,574
10900,1324812638,1324812640,1324813207,2,567
10907,1324812655,1324812670,1324813654,15,984
10902,1324812643,1324812655,1324813643,12,988
10903,1324812645,1324812655,1324813645,10,990
10901,1324812640,1324812655,1324813707,15,1052
10910,1324812663,1324812670,1324813753,7,1083
10908,1324812657,1324812670,1324813748,13,1078
10911,1324812665,1324812670,1324813751,5,1081
10909,1324812660,1324812670,1324813754,10,1084
10916,1324813727,1324813735,1324813736,8,1
10823,1324549900,1324549915,1324829833,15,279918
10793,1324463929,1324463935,1324846785,6,382850
10915,1324813373,1324813375,1324854874,2,41499
10412,1323168889,1323229990,1324862882,61101,1632892
10923,1324869008,1324869010,1324869011,2,1
10928,1324870816,1324870825,1324870826,9,1
10849,1324629482,1324629490,1324902069,8,272579
10926,1324870452,1324870465,1324902693,13,32228
10927,1324870612,1324908790,1324908792,38178,2
10850,1324629485,1324629490,1324922380,5,292890
10854,1324629498,1324629505,1324972298,7,342793
10941,1325008746,1325008750,1325008750,4,0
10945,1325008894,1325008900,1325008906,6,6
10852,1324629491,1324629505,1325010379,14,380874
10445,1323246528,1323246535,1325018225,7,1771690
10938,1325007722,1325007730,1325025397,8,17667
10937,1325007718,1325007730,1325025929,12,18199
10794,1324464801,1324464805,1325037577,4,572772
10878,1324645933,1324646815,1325038180,882,391365
10939,1325007728,1325007730,1325046492,2,38762
10946,1325087697,1325087710,1325087716,13,6
10954,1325104659,1325104660,1325104842,1,182
10955,1325104662,1325104675,1325105007,13,332
10953,1325104656,1325104660,1325105094,4,434
10949,1325091569,1325091580,1325107516,11,15936
10948,1325091561,1325091565,1325115010,4,23445
10632,1323771990,1323772001,1325135693,11,1363692
10950,1325097527,1325097535,1325146443,8,48908
10951,1325097558,1325097565,1325159011,7,61446
10956,1325170993,1325171005,1325171011,12,6
10957,1325171258,1325171260,1325171266,2,6
10958,1325171370,1325171380,1325171386,10,6
10959,1325171540,1325171545,1325171551,5,6
10960,1325171615,1325171620,1325171626,5,6
10961,1325171755,1325171770,1325171776,15,6
10940,1325008107,1325101210,1325171904,93103,70694
10947,1325091483,1325091490,1325178474,7,86984
10962,1325184027,1325184040,1325184627,13,587
10963,1325194725,1325194735,1325194735,10,0
10851,1324629488,1324629490,1325196521,2,567031
10930,1324910173,1324910200,1325201525,27,291325
10964,1325216447,1325216455,1325217203,8,748
10965,1325217631,1325217640,1325217643,9,3
10969,1325218300,1325218315,1325218319,15,4
10968,1325218296,1325218300,1325218303,4,3
10966,1325218132,1325218135,1325218541,3,406
10967,1325218293,1325218300,1325218752,7,452
10970,1325219206,1325219215,1325219218,9,3
10971,1325219280,1325219290,1325219311,10,21
10972,1325219299,1325219305,1325219325,6,20
10975,1325219963,1325219965,1325219996,2,31
10976,1325219967,1325219980,1325220006,13,26
10921,1324869001,1324869010,1325228535,9,359525
10944,1325008842,1325008855,1325248087,13,239232
10922,1324869005,1324869010,1325254874,5,385864
10979,1325265406,1325265416,1325265417,10,1
10933,1325006438,1325101210,1325274005,94772,172795
10981,1325276044,1325276050,1325276051,6,1
10982,1325276157,1325276170,1325276171,13,1
10952,1325098094,1325245555,1325276457,147461,30902
10932,1325006329,1325006335,1325361818,6,355483
9347,1321011790,1321044295,1325370527,32505,4326232
10984,1325360530,1325360545,1325374356,15,13811
10987,1325360748,1325360755,1325374499,7,13744
10986,1325360743,1325360755,1325385258,12,24503
10988,1325360824,1325360830,1325394059,6,33229
10989,1325360841,1325360845,1325398705,4,37860
10758,1324218419,1324218430,1325400801,11,1182371
10985,1325360535,1325360545,1325416895,10,56350
10925,1324869857,1324869865,1325455068,8,585203
10924,1324869010,1324869025,1325470630,15,601605
10990,1325478780,1325478790,1325482655,10,3865
10991,1325485406,1325485420,1325491874,14,6454
10996,1325489395,1325489410,1325497525,15,8115
10992,1325486130,1325486140,1325500788,10,14648
10993,1325486615,1325486620,1325508909,5,22289
10994,1325488241,1325488255,1325552261,14,64006
10997,1325539691,1325539705,1325561624,14,21919
10998,1325539838,1325539840,1325563274,2,23434
10974,1325219796,1325219800,1325564723,4,344923
10999,1325539990,1325540005,1325566250,15,26245
11000,1325569173,1325569180,1325569181,7,1
11002,1325569763,1325569765,1325588407,2,18642
10752,1324140648,1324140655,1325591193,7,1450538
10973,1325219784,1325219785,1325596999,1,377214
10995,1325488374,1325488376,1325600210,2,111834
11006,1325583096,1325583100,1325603580,4,20480
11005,1325582636,1325582650,1325605510,14,22860
11003,1325569771,1325569780,1325608986,9,39206
11004,1325579272,1325579275,1325638451,3,59176
11009,1325728309,1325728315,1325728316,6,1
9201,1320605320,1320605335,1325728975,15,5123640
11013,1325728962,1325728975,1325728976,13,1
11014,1325729046,1325729050,1325729051,4,1
11015,1325729163,1325729170,1325729171,7,1
11016,1325729302,1325729305,1325729306,3,1
11019,1325730437,1325730445,1325730446,8,1
11020,1325730890,1325730895,1325730896,5,1
11007,1325714286,1325714290,1325734070,4,19780
10917,1324813826,1324813840,1325735736,14,921896
10983,1325360261,1325360275,1325740084,14,379809
11012,1325728806,1325728810,1325741066,4,12256
11008,1325714642,1325714650,1325744782,8,30132
11023,1325741211,1325741215,1325751292,4,10077
11022,1325740804,1325740810,1325757439,6,16629
11021,1325731097,1325731105,1325771052,8,39947
11024,1325777283,1325777290,1325777296,7,6
10918,1324813829,1324813840,1325790327,11,976487
10978,1325220177,1325220190,1325800464,13,580274
11028,1325830240,1325830255,1325830256,15,1
11025,1325801777,1325801785,1325831346,8,29561
11026,1325801892,1325801906,1325836255,14,34349
11027,1325818924,1325818930,1325846947,6,28017
11030,1325848092,1325848105,1325848111,13,6
11010,1325728388,1325728390,1325879495,2,151105
11029,1325830687,1325830690,1325887257,3,56567
10233,1322988365,1323359665,1325925993,371300,2566328
11034,1325973186,1325973190,1325973190,4,0
11033,1325973178,1325973190,1325973190,12,0
11001,1325569541,1325569555,1325977755,14,408200
11049,1325977852,1325977855,1325977855,3,0
11035,1325973192,1325973205,1325984934,13,11729
11048,1325974200,1325974210,1325987178,10,12968
11039,1325973705,1325973715,1325987471,10,13756
11047,1325974189,1325974195,1325989855,6,15660
11046,1325974057,1325974060,1325989928,3,15868
11045,1325974051,1325974060,1325992367,9,18307
11032,1325968753,1325968765,1325998525,12,29760
11040,1325973710,1325973715,1325998610,5,24895
11037,1325973604,1325973610,1326003480,6,29870
11042,1325973825,1325973835,1326006872,10,33037
11043,1325973828,1325973835,1326010891,7,37056
11041,1325973818,1325973820,1326013453,2,39633
10702,1323938493,1323938500,1326015758,7,2077258
11036,1325973571,1325973580,1326028424,9,54844
11031,1325927196,1325927200,1326035651,4,108451
11044,1325974045,1325974060,1326045479,15,71419
11058,1326065383,1326065395,1326065400,12,5
11057,1326064913,1326064915,1326072599,2,7684
11053,1326057453,1326057462,1326074268,9,16806
11051,1326056412,1326056425,1326084451,13,28026
11056,1326064336,1326064346,1326084674,10,20328
11060,1326065778,1326065785,1326086035,7,20250
11061,1326073055,1326073060,1326086462,5,13402
11055,1326063662,1326063671,1326089884,9,26213
11054,1326062861,1326062875,1326092490,14,29615
11059,1326065586,1326065590,1326093796,4,28206
11064,1326093818,1326093821,1326100403,3,6582
11062,1326085605,1326085616,1326100669,11,15053
11038,1325973697,1325973700,1326101871,3,128171
11065,1326093977,1326093985,1326103867,8,9882
11052,1326056695,1326056710,1326107338,15,50628
11068,1326107809,1326107815,1326107822,6,7
11069,1326107926,1326107935,1326107942,9,7
11070,1326108412,1326108415,1326108421,3,6
11063,1326093753,1326093760,1326115589,7,21829
11071,1326119775,1326119785,1326119791,10,6
11072,1326120300,1326120310,1326120316,10,6
11073,1326120778,1326120790,1326120796,12,6
11074,1326121088,1326121090,1326121095,2,5
11075,1326121269,1326121270,1326121276,1,6
11076,1326122497,1326122500,1326122505,3,5
11077,1326122554,1326122560,1326122566,6,6
11078,1326122781,1326122785,1326122795,4,10
11079,1326122983,1326122995,1326123001,12,6
11080,1326124143,1326124150,1326124156,7,6
11081,1326124145,1326124150,1326124156,5,6
11082,1326124306,1326124315,1326124321,9,6
11083,1326124500,1326124510,1326124516,10,6
11085,1326156219,1326156220,1326165463,1,9243
11086,1326158268,1326158275,1326169193,7,10918
11088,1326162134,1326162146,1326172631,12,10485
11089,1326194391,1326194395,1326194402,4,7
11090,1326195654,1326195655,1326195665,1,10
11091,1326195699,1326195700,1326195716,1,16
11092,1326195752,1326195760,1326195780,8,20
11093,1326195789,1326195790,1326195829,1,39
11094,1326195836,1326195850,1326195856,14,6
11095,1326197658,1326197665,1326197678,7,13
11097,1326197662,1326197665,1326197703,3,38
11096,1326197660,1326197665,1326197717,5,52
11101,1326197740,1326197755,1326197765,15,10
11102,1326197742,1326197755,1326197773,13,18
11103,1326197744,1326197755,1326197780,11,25
11098,1326197665,1326197680,1326197800,15,120
11100,1326197733,1326197740,1326197747,7,7
11104,1326197746,1326197755,1326197796,9,41
11099,1326197667,1326197680,1326197876,13,196
11108,1326198306,1326198310,1326198310,4,0
11110,1326198450,1326198565,1326198565,115,0
11111,1326198603,1326198610,1326198610,7,0
11112,1326199546,1326199555,1326199795,9,240
11113,1326200255,1326200260,1326201216,5,956
11116,1326201499,1326201505,1326201693,6,188
11118,1326201556,1326201565,1326201720,9,155
11115,1326201174,1326201175,1326202361,1,1186
11120,1326202345,1326202360,1326202474,15,114
11117,1326201541,1326201550,1326202527,9,977
11126,1326203585,1326203590,1326203613,5,23
11127,1326203588,1326203590,1326203625,2,35
11128,1326203589,1326203590,1326203653,1,63
11129,1326203591,1326203605,1326203717,14,112
11132,1326203650,1326203665,1326203743,15,78
11130,1326203593,1326203605,1326203769,12,164
11131,1326203649,1326203650,1326204038,1,388
11136,1326204244,1326204250,1326204283,6,33
11137,1326204246,1326204250,1326204300,4,50
11133,1326203653,1326203665,1326204360,12,695
11138,1326204248,1326204250,1326204339,2,89
11119,1326201830,1326201835,1326204413,5,2578
11139,1326204251,1326204265,1326204876,14,611
11140,1326204253,1326204265,1326205219,12,954
11134,1326203655,1326203665,1326205359,10,1694
11142,1326205427,1326205435,1326205712,8,277
11143,1326205429,1326205435,1326206058,6,623
11124,1326202954,1326202960,1326206136,6,3176
11135,1326203657,1326203665,1326206855,8,3190
11141,1326205421,1326205435,1326206984,14,1549
11144,1326205431,1326205435,1326207131,4,1696
11147,1326206949,1326206950,1326207677,1,727
11148,1326207721,1326207730,1326207737,9,7
11145,1326205433,1326205435,1326208608,2,3173
11067,1326101746,1326101755,1326213528,9,111773
11146,1326206929,1326206935,1326217216,6,10281
11017,1325729895,1325729905,1326230072,10,500167
11084,1326154822,1326154826,1326231099,4,76273
11087,1326161336,1326161350,1326234764,14,73414
11149,1326231089,1326231100,1326241570,11,10470
11150,1326231112,1326231115,1326244234,3,13119
11152,1326231266,1326231280,1326244827,14,13547
11153,1326234811,1326234820,1326251133,9,16313
11151,1326231184,1326231190,1326254784,6,23594
10920,1324868916,1324868920,1326297519,4,1428599
11160,1326325804,1326325810,1326330254,6,4444
11161,1326326840,1326326845,1326333891,5,7046
10919,1324813876,1324813885,1326334747,9,1520862
11157,1326320676,1326320680,1326334932,4,14252
11162,1326329259,1326329260,1326335264,1,6004
11165,1326335822,1326335830,1326335867,8,37
11159,1326324640,1326324663,1326335913,23,11250
11163,1326329919,1326329920,1326336000,1,6080
11158,1326320897,1326320905,1326337273,8,16368
11164,1326333640,1326333655,1326337845,15,4190
11155,1326320043,1326320050,1326363093,7,43043
11169,1326364633,1326364645,1326364650,12,5
11018,1325730108,1325730115,1326365397,7,635282
11173,1326364891,1326364900,1326372449,9,7549
11168,1326364563,1326364570,1326372965,7,8395
11170,1326364701,1326364705,1326374597,4,9892
11121,1326202425,1326202435,1326377113,10,174678
11171,1326364757,1326364766,1326383712,9,18946
11172,1326364823,1326364825,1326384123,2,19298
11174,1326384319,1326384325,1326384327,6,2
11175,1326384376,1326384385,1326384393,9,8
11176,1326384418,1326384430,1326384438,12,8
11177,1326384470,1326384475,1326384487,5,12
11178,1326384715,1326384730,1326384739,15,9
11179,1326384937,1326384940,1326385003,3,63
11180,1326385047,1326385060,1326385067,13,7
11181,1326385144,1326385152,1326385232,8,80
11122,1326202836,1326202840,1326385294,4,182454
11123,1326202909,1326202915,1326385301,6,182386
11182,1326385286,1326385300,1326385313,14,13
11183,1326385377,1326385390,1326385403,13,13
11125,1326202994,1326203005,1326385443,11,182438
11184,1326385436,1326385450,1326385474,14,24
11185,1326385497,1326385510,1326385518,13,8
11186,1326385632,1326385645,1326385653,13,8
11187,1326385860,1326385870,1326385880,10,10
11188,1326386001,1326386005,1326386018,4,13
11189,1326386053,1326386065,1326386074,12,9
11190,1326386130,1326386140,1326386150,10,10
11191,1326386218,1326386230,1326386262,12,32
11192,1326386300,1326386305,1326386314,5,9
11193,1326386345,1326386350,1326386363,5,13
11194,1326388681,1326388690,1326388703,9,13
11195,1326388826,1326388840,1326388853,14,13
11196,1326388893,1326388900,1326388908,7,8
11197,1326388927,1326388930,1326388944,3,14
11198,1326388986,1326388990,1326389003,4,13
11199,1326389182,1326389185,1326389198,3,13
11167,1326364500,1326364510,1326407948,10,43438
11200,1326407923,1326407935,1326407940,12,5
11202,1326408957,1326408970,1326408975,13,5
11201,1326407958,1326407965,1326420516,7,12551
11203,1326409051,1326409060,1326423082,9,14022
11207,1326429456,1326429460,1326429674,4,214
11204,1326410377,1326410380,1326430229,3,19849
11212,1326431650,1326431665,1326431762,15,97
11213,1326431773,1326431786,1326432290,13,504
11210,1326429820,1326429835,1326432583,15,2748
11206,1326429329,1326429340,1326433124,11,3784
11209,1326429791,1326429805,1326434920,14,5115
11208,1326429649,1326429655,1326435209,6,5554
11215,1326445894,1326445900,1326446120,6,220
11216,1326446104,1326446110,1326446164,6,54
11217,1326446151,1326446155,1326446380,4,225
11218,1326447095,1326447100,1326447116,5,16
11219,1326447109,1326447115,1326447339,6,224
11220,1326449906,1326449920,1326449992,14,72
11221,1326450245,1326450250,1326450263,5,13
11222,1326450311,1326450325,1326450338,14,13
11223,1326450369,1326450370,1326450378,1,8
11224,1326450408,1326450415,1326450595,7,180
11225,1326451276,1326451285,1326451298,9,13
11226,1326451315,1326451330,1326451343,15,13
11227,1326451357,1326451360,1326451369,3,9
11228,1326451391,1326451405,1326451414,14,9
11229,1326451440,1326451450,1326451540,10,90
11230,1326451582,1326451585,1326451586,3,1
11231,1326451639,1326451645,1326451653,6,8
11232,1326451672,1326451675,1326451753,3,78
11233,1326451813,1326451825,1326451904,12,79
11234,1326453047,1326453055,1326453057,8,2
11235,1326453384,1326453385,1326453386,1,1
11236,1326454072,1326454075,1326454076,3,1
11237,1326454327,1326454330,1326454331,3,1
11238,1326454428,1326454428,1326454549,0,121
11239,1326454710,1326454713,1326454714,3,1
11240,1326454903,1326454908,1326455153,5,245
11241,1326455679,1326455688,1326455689,9,1
11211,1326431182,1326431185,1326455731,3,24546
11242,1326455900,1326455900,1326455948,0,48
11243,1326456203,1326456215,1326456356,12,141
11244,1326456444,1326456455,1326456589,11,134
11245,1326456552,1326456560,1326456805,8,245
11246,1326456944,1326456950,1326457085,6,135
11247,1326459291,1326459305,1326459589,14,284
11248,1326459299,1326459305,1326459589,6,284
11249,1326460403,1326460415,1326460415,12,0
11251,1326461426,1326461436,1326461683,10,247
11250,1326461415,1326461420,1326461732,5,312
11252,1326463078,1326463085,1326463086,7,1
11253,1326463171,1326463178,1326463183,7,5
11254,1326463317,1326463325,1326463327,8,2
11259,1326464332,1326464345,1326464680,13,335
11260,1326466279,1326466280,1326466284,1,4
11261,1326466338,1326466340,1326467828,2,1488
11263,1326470437,1326470450,1326470454,13,4
11264,1326471581,1326471590,1326471591,9,1
11265,1326471667,1326471680,1326471683,13,3
11266,1326471761,1326471770,1326472617,9,847
11205,1326422917,1326422921,1326486835,4,63914
11256,1326464145,1326464150,1326529980,5,65830
11154,1326319808,1326319810,1326545645,2,225835
11214,1326432463,1326432475,1326598846,12,166371
11255,1326464006,1326464015,1326619107,9,155092
11267,1326618734,1326618740,1326626903,6,8163
11271,1326668862,1326668870,1326671307,8,2437
11270,1326668106,1326668120,1326675061,14,6941
11276,1326676392,1326676400,1326676589,8,189
11272,1326674382,1326674390,1326681064,8,6674
11268,1326667724,1326667730,1326684030,6,16300
11277,1326684481,1326684485,1326684673,4,188
11278,1326685181,1326685190,1326685194,9,4
11279,1326685682,1326685685,1326685846,3,161
11280,1326685960,1326685970,1326686115,10,145
11281,1326686024,1326686030,1326694024,6,7994
11262,1326469916,1326469925,1326705241,9,235316
11284,1326705660,1326705665,1326705668,5,3
11285,1326705677,1326705680,1326705686,3,6
11289,1326707263,1326707270,1326707276,7,6
11287,1326706424,1326706430,1326707865,6,1435
11291,1326715308,1326715310,1326715310,2,0
11292,1326715944,1326715955,1326715955,11,0
11293,1326716011,1326716015,1326716044,4,29
11294,1326716878,1326716885,1326716891,7,6
11295,1326716934,1326716945,1326716952,11,7
11286,1326706079,1326706085,1326719314,6,13229
11288,1326706528,1326706535,1326722591,7,16056
11290,1326707532,1326707540,1326722593,8,15053
11302,1326725825,1326725840,1326725846,15,6
11301,1326725354,1326725360,1326725905,6,545
11303,1326726277,1326726290,1326726297,13,7
11304,1326726382,1326726395,1326726399,13,4
11305,1326726774,1326726785,1326727174,11,389
11308,1326728410,1326728420,1326728423,10,3
11307,1326728238,1326728240,1326728659,2,419
11269,1326668047,1326668060,1326748605,13,80545
11312,1326748584,1326748595,1326748601,11,6
11314,1326748697,1326748700,1326748705,3,5
11310,1326731364,1326731464,1326749424,100,17960
11317,1326751155,1326751161,1326751165,6,4
11318,1326751569,1326751587,1326751661,18,74
11319,1326751599,1326751611,1326751620,12,9
11321,1326752009,1326752018,1326752043,9,25
11316,1326749558,1326749571,1326752455,13,2884
11322,1326753019,1326753025,1326753534,6,509
11324,1326753511,1326753515,1326753749,4,234
11326,1326753861,1326753875,1326756334,14,2459
11313,1326748618,1326748626,1326756750,8,8124
11311,1326748522,1326748535,1326760111,13,11576
11329,1326761361,1326761376,1326761380,15,4
11331,1326761682,1326761690,1326764507,8,2817
11315,1326749476,1326749480,1326764920,4,15440
11333,1326765720,1326765726,1326765731,6,5
11334,1326766392,1326766400,1326771447,8,5047
11327,1326760773,1326760776,1326771556,3,10780
11323,1326753152,1326753156,1326772068,4,18912
11332,1326765473,1326765485,1326773107,12,7622
11330,1326761456,1326761465,1326778391,9,16926
11328,1326760946,1326760961,1326778449,15,17488
11337,1326778459,1326778460,1326780154,1,1694
11340,1326780145,1326780155,1326783026,10,2871
11338,1326779500,1326779510,1326785667,10,6157
11335,1326768562,1326768575,1326785901,13,17326
11296,1326722691,1326722705,1326788451,14,65746
11342,1326783585,1326783590,1326790027,5,6437
11336,1326778263,1326778265,1326791290,2,13025
11339,1326779602,1326779615,1326794531,13,14916
11343,1326799272,1326799280,1326799298,8,18
11344,1326799576,1326799580,1326799587,4,7
11282,1326705284,1326705290,1326807552,6,102262
11283,1326705368,1326705380,1326807607,12,102227
11346,1326810647,1326810650,1326811008,3,358
11347,1326811208,1326811224,1326812893,16,1669
11349,1326812655,1326812660,1326813820,5,1160
11350,1326814287,1326814295,1326814301,8,6
11351,1326815973,1326815975,1326815981,2,6
11345,1326807517,1326807530,1326818936,13,11406
11320,1326751654,1326751711,1326828942,57,77231
11341,1326783514,1326783516,1326829837,2,46321
11356,1326831856,1326831860,1326831862,4,2
11353,1326830849,1326830855,1326837405,6,6550
11355,1326831023,1326831035,1326838731,12,7696
11359,1326835438,1326835446,1326842003,8,6557
11358,1326833888,1326833900,1326847258,12,13358
11354,1326830945,1326830960,1326848671,15,17711
11365,1326850724,1326850731,1326850736,7,5
11363,1326843370,1326843381,1326855341,11,11960
11306,1326727360,1326727370,1326857453,10,130083
11366,1326857672,1326857675,1326857680,3,5
11352,1326830730,1326830736,1326858271,6,27535
11369,1326860162,1326860166,1326860190,4,24
11297,1326722730,1326722735,1326872671,5,149936
11360,1326842680,1326842691,1326873132,11,30441
11362,1326843058,1326843065,1326875289,7,32224
11373,1326877101,1326877115,1326877116,14,1
11374,1326877168,1326877175,1326877202,7,27
11375,1326877984,1326877985,1326878005,1,20
11376,1326878026,1326878030,1326878052,4,22
11377,1326878097,1326878105,1326878127,8,22
11372,1326876294,1326876305,1326878295,11,1990
11364,1326849601,1326849605,1326887199,4,37594
11368,1326859838,1326859851,1326891964,13,32113
11370,1326860298,1326860301,1326895315,3,35014
11325,1326753545,1326753563,1326899388,18,145825
11378,1326907059,1326907059,1326907074,0,15
11379,1326907085,1326907089,1326907089,4,0
11380,1326907685,1326907689,1326907694,4,5
11348,1326811281,1326811295,1326909358,14,98063
11381,1326909849,1326909864,1326909864,15,0
11382,1326910033,1326910045,1326910054,12,9
11383,1326910629,1326910644,1326910647,15,3
11384,1326910770,1326910779,1326910783,9,4
11385,1326910811,1326910824,1326910829,13,5
11386,1326910821,1326910824,1326910829,3,5
11387,1326911216,1326911229,1326911234,13,5
11299,1326722788,1326722795,1326913839,7,191044
11300,1326722805,1326722810,1326913956,5,191146
11309,1326731166,1326731180,1326914149,14,182969
11357,1326833307,1326833320,1326920854,13,87534
11367,1326857699,1326857706,1326920883,7,63177
11393,1326931301,1326931314,1326931456,13,142
11392,1326931292,1326931299,1326932290,7,991
11394,1326931312,1326931314,1326932294,2,980
11390,1326920876,1326920890,1326938167,14,17277
11371,1326860324,1326860331,1326944663,7,84332
11391,1326921051,1326921055,1326945474,4,24419
11388,1326920768,1326920770,1326946819,2,26049
11389,1326920850,1326920860,1326953242,10,32382
11396,1326970639,1326970644,1326970675,5,31
11403,1326984176,1326984189,1326984208,13,19
11404,1326986020,1326986034,1326986065,14,31
11395,1326932475,1326932484,1326994729,9,62245
11258,1326464271,1326464285,1327004854,14,540569
11397,1326981558,1326981564,1327006008,6,24444
11399,1326981678,1326981684,1327007174,6,25490
11401,1326981764,1326981774,1327008431,10,26657
11409,1327009016,1327009029,1327009033,13,4
11410,1327009021,1327009029,1327009033,8,4
11411,1327009025,1327009029,1327009516,4,487
11421,1327013653,1327013665,1327018557,12,4892
11420,1327011989,1327012000,1327019008,11,7008
11400,1326981718,1326981729,1327021200,11,39471
11408,1327008428,1327008429,1327024374,1,15945
11402,1326981823,1326981834,1327031440,11,49606
11398,1326981638,1326981639,1327038987,1,57348
11257,1326464227,1326464240,1327040823,13,576583
11426,1327051486,1327051494,1327055321,8,3827
11429,1327055880,1327055889,1327055909,9,20
11430,1327055887,1327055889,1327055911,2,22
11431,1327055891,1327055904,1327055927,13,23
11432,1327055893,1327055904,1327055924,11,20
11433,1327055895,1327055904,1327055926,9,22
11434,1327055898,1327055904,1327055926,6,22
11435,1327057699,1327057704,1327057710,5,6
11436,1327057701,1327057704,1327057718,3,14
11437,1327057703,1327057704,1327057723,1,19
11438,1327057705,1327057719,1327057754,14,35
11439,1327057706,1327057719,1327057765,13,46
11416,1327010512,1327010514,1327075664,2,65150
11423,1327051317,1327051329,1327076687,12,25358
11422,1327051072,1327051074,1327084021,2,32947
11419,1327011220,1327011234,1327091487,14,80253
11415,1327010232,1327010245,1327091591,13,81346
11441,1327091308,1327091319,1327101867,11,10548
11424,1327051398,1327051404,1327103093,6,51689
11440,1327091302,1327091304,1327105940,2,14636
11447,1327091673,1327091679,1327107511,6,15832
11405,1327007576,1327007589,1327115330,13,107741
11443,1327091473,1327091484,1327119401,11,27917
11446,1327091665,1327091679,1327130817,14,39138
11445,1327091484,1327091499,1327132040,15,40541
11442,1327091313,1327091319,1327133019,6,41700
11444,1327091479,1327091484,1327142202,5,50718
11413,1327009890,1327009899,1327146040,9,136141
11449,1327148545,1327148559,1327148772,14,213
11450,1327148620,1327148634,1327150747,14,2113
11448,1327091678,1327091679,1327162864,1,71185
10977,1325220174,1325220175,1327169094,1,1948919
11412,1327009887,1327009899,1327188993,12,179094
11428,1327051544,1327051554,1327198292,10,146738
11414,1327009893,1327009899,1327218527,6,208628
11452,1327194905,1327194910,1327227895,5,32985
11451,1327194749,1327194760,1327230320,11,35560
11453,1327195024,1327195030,1327241613,6,46583
11456,1327261845,1327261854,1327295357,9,33503
11454,1327261830,1327261839,1327298642,9,36803
11425,1327051453,1327051464,1327309067,11,257603
11427,1327051518,1327051524,1327312440,6,260916
11465,1327310219,1327310219,1327317681,0,7462
11459,1327307279,1327307289,1327329514,10,22225
11466,1327330670,1327330679,1327330685,9,6
11467,1327332307,1327332314,1327332335,7,21
11468,1327334889,1327334894,1327334929,5,35
11469,1327334975,1327334984,1327335027,9,43
11298,1326722752,1326722765,1327348800,13,626035
11417,1327010524,1327010529,1327350724,5,340195
11458,1327307233,1327307244,1327364989,11,57745
11474,1327369379,1327369395,1327369400,16,5
11472,1327367908,1327367910,1327372383,2,4473
11473,1327368633,1327368645,1327377996,12,9351
11478,1327383354,1327383360,1327388766,6,5406
11481,1327385258,1327385265,1327389995,7,4730
11479,1327384818,1327384830,1327391591,12,6761
11480,1327385124,1327385130,1327396679,6,11549
11455,1327261840,1327261854,1327403305,14,141451
11483,1327396358,1327396364,1327407482,6,11118
11463,1327307411,1327307424,1327408403,13,100979
11482,1327391323,1327391325,1327414969,2,23644
11476,1327382490,1327382505,1327417647,15,35142
11475,1327374161,1327374165,1327422924,4,48759
11477,1327383080,1327383090,1327442662,10,59572
11489,1327443712,1327443720,1327451703,8,7983
11486,1327441693,1327441695,1327454163,2,12468
11485,1327441488,1327441500,1327455618,12,14118
11471,1327350880,1327350886,1327457118,6,106232
11488,1327442690,1327442701,1327458405,11,15704
11491,1327458688,1327458689,1327458690,1,1
11492,1327458774,1327458779,1327458781,5,2
11493,1327458778,1327458779,1327458781,1,2
11494,1327458854,1327458869,1327458870,15,1
11498,1327458988,1327458989,1327462063,1,3074
11497,1327458985,1327458989,1327462042,4,3053
11496,1327458928,1327458929,1327462344,1,3415
11487,1327442301,1327442387,1327465570,86,23183
11499,1327460571,1327460581,1327466523,10,5942
11502,1327466268,1327466280,1327474359,12,8079
11457,1327307162,1327307169,1327478508,7,171339
11503,1327467142,1327467151,1327486838,9,19687
11501,1327461068,1327461075,1327493277,7,32202
11506,1327496506,1327496519,1327496543,13,24
11500,1327460897,1327460910,1327497408,13,36498
11514,1327498215,1327498229,1327498794,14,565
11507,1327497993,1327498004,1327499036,11,1032
11508,1327498047,1327498049,1327500768,2,2719
11510,1327498119,1327498124,1327500825,5,2701
11509,1327498102,1327498111,1327500877,9,2766
11511,1327498208,1327498214,1327502094,6,3880
11512,1327498211,1327498214,1327502097,3,3883
11513,1327498212,1327498214,1327502100,2,3886
11516,1327502159,1327502174,1327502257,15,83
11517,1327502162,1327502174,1327502253,12,79
11518,1327502166,1327502174,1327502260,8,86
11519,1327502169,1327502174,1327502258,5,84
11520,1327502171,1327502174,1327502259,3,85
11521,1327502697,1327502699,1327502815,2,116
11522,1327502700,1327502714,1327502861,14,147
11523,1327502705,1327502714,1327502866,9,152
11524,1327502707,1327502714,1327502869,7,155
11525,1327502710,1327502714,1327502869,4,155
11526,1327504620,1327504634,1327504660,14,26
11527,1327504623,1327504634,1327504657,11,23
11505,1327491390,1327491404,1327521892,14,30488
11484,1327407495,1327407510,1327539538,15,132028
11464,1327307441,1327307454,1327544678,13,237224
11504,1327491356,1327491359,1327548496,3,57137
11529,1327565342,1327565354,1327565465,12,111
11530,1327572688,1327572689,1327572774,1,85
11532,1327573202,1327573214,1327573330,12,116
11534,1327573492,1327573499,1327573588,7,89
11535,1327573561,1327573574,1327573667,13,93
11495,1327458894,1327458899,1327576886,5,117987
11572,1327579425,1327579439,1327579442,14,3
11573,1327579612,1327579619,1327579622,7,3
11574,1327579618,1327579619,1327579622,1,3
11575,1327579624,1327579634,1327579637,10,3
11581,1327580771,1327580774,1327580777,3,3
11580,1327580749,1327580759,1327580762,10,3
11582,1327580775,1327580789,1327580792,14,3
11583,1327580779,1327580789,1327580792,10,3
11460,1327307308,1327307319,1327586104,11,278785
11531,1327573096,1327573109,1327591056,13,17947
11536,1327573730,1327573739,1327593206,9,19467
11537,1327573833,1327573844,1327596219,11,22375
11551,1327575638,1327575644,1327598660,6,23016
11533,1327573397,1327573409,1327600296,12,26887
11563,1327577428,1327600304,1327600305,22876,1
11548,1327575627,1327575629,1327604316,2,28687
11588,1327591070,1327591081,1327610682,11,19601
11549,1327575632,1327575644,1327611445,12,35801
11547,1327575624,1327575629,1327615327,5,39698
11546,1327575621,1327575629,1327616807,8,41178
11554,1327575646,1327586294,1327618525,10648,32231
11542,1327574684,1327574699,1327620658,15,45959
11543,1327574687,1327574699,1327621177,12,46478
11553,1327575643,1327576904,1327621355,1261,44451
11539,1327574667,1327574669,1327621387,2,46718
11011,1325728669,1325728675,1327622597,6,1893922
11538,1327574664,1327574669,1327624223,5,49554
11557,1327575653,1327596254,1327626321,20601,30067
11541,1327574675,1327574684,1327626627,9,51943
11564,1327578051,1327600349,1327630265,22298,29916
11590,1327625998,1327626001,1327633831,3,7830
11552,1327575640,1327575644,1327634730,4,59086
11576,1327580255,1327621394,1327635709,41139,14315
11592,1327628260,1327630306,1327636099,2046,5793
11577,1327580257,1327621409,1327637016,41152,15607
11550,1327575635,1327575644,1327637721,9,62077
11578,1327580260,1327622609,1327638818,42349,16209
11565,1327578055,1327604339,1327639026,26284,34687
11585,1327582345,1327626659,1327640334,44314,13675
11584,1327582330,1327626329,1327641598,43999,15269
11544,1327574690,1327574699,1327641791,9,67092
11566,1327578057,1327611494,1327644735,33437,33241
11555,1327575648,1327591079,1327644990,15431,53911
11568,1327579194,1327616834,1327646237,37640,29403
11593,1327634036,1327634040,1327646931,4,12891
11579,1327580262,1327624274,1327650117,44012,25843
11556,1327575651,1327593254,1327650215,17603,56961
11587,1327582357,1327635749,1327655583,53392,19834
11567,1327578060,1327615349,1327655920,37289,40571
11570,1327579200,1327620704,1327656700,41504,35996
11586,1327582353,1327634759,1327656868,52406,22109
11571,1327579203,1327621214,1327664049,42011,42835
11625,1327670450,1327670450,1327670454,0,4
11626,1327670455,1327670455,1327670458,0,3
11627,1327670460,1327670460,1327670464,0,4
11540,1327574673,1327574684,1327675428,11,100744
11605,1327665452,1327665464,1327677092,12,11628
11600,1327665440,1327665449,1327677535,9,12086
11607,1327665458,1327665464,1327677702,6,12238
11598,1327665434,1327665449,1327677767,15,12318
11604,1327665450,1327665464,1327680716,14,15252
11597,1327665431,1327665434,1327681963,3,16529
11599,1327665437,1327665449,1327689961,12,24512
11608,1327665461,1327665464,1327690445,3,24981
11601,1327665443,1327665449,1327690570,6,25121
11612,1327665470,1327677735,1327692964,12265,15229
11603,1327665447,1327665449,1327693255,2,27806
11614,1327665476,1327680750,1327694650,15274,13900
11589,1327623938,1327623951,1327694988,13,71037
11611,1327665468,1327677570,1327695045,12102,17475
11596,1327665427,1327665434,1327696497,7,31063
11629,1327689593,1327690590,1327698922,997,8332
11561,1327576820,1327576829,1327699550,9,122721
11630,1327689597,1327692990,1327700906,3393,7916
11560,1327576806,1327576814,1327701105,8,124291
11602,1327665445,1327665449,1327701130,4,35681
11632,1327689606,1327694670,1327702546,5064,7876
11606,1327665455,1327665464,1327705278,9,39814
11462,1327307377,1327307379,1327705298,2,397919
11595,1327665425,1327665434,1327705554,9,40120
11613,1327665473,1327677810,1327705720,12337,27910
11631,1327689601,1327693305,1327706029,3704,12724
11635,1327689631,1327698945,1327706901,9314,7956
11628,1327689589,1327690470,1327708403,881,17933
11637,1327689656,1327701150,1327708406,11494,7256
11633,1327689619,1327695090,1327708561,5471,13471
11594,1327652032,1327652040,1327708559,8,56519
11615,1327665478,1327681995,1327709599,16517,27604
11634,1327689628,1327696530,1327710989,6902,14459
11639,1327689663,1327705290,1327712944,15627,7654
11655,1327712971,1327712985,1327713006,14,21
11610,1327665466,1327677120,1327713871,11654,36751
11643,1327689676,1327706940,1327715082,17264,8142
11638,1327689659,1327702560,1327715245,12901,12685
11636,1327689638,1327700940,1327717405,11302,16465
11645,1327689686,1327708425,1327718447,18739,10022
11650,1327689717,1327708635,1327720358,18918,11723
11609,1327665463,1327675470,1327720491,10007,45021
11652,1327689724,1327711005,1327720483,21281,9478
11640,1327689667,1327705575,1327720735,15908,15160
11649,1327689698,1327708635,1327721131,18937,12496
11644,1327689679,1327708425,1327728189,18746,19764
11651,1327689719,1327709640,1327729609,19921,19969
11646,1327689687,1327708575,1327730539,18888,21964
11648,1327689693,1327708635,1327731253,18942,22618
11641,1327689670,1327705725,1327733140,16055,27415
11642,1327689673,1327706055,1327734049,16382,27994
11647,1327689690,1327708635,1327737321,18945,28686
11653,1327689727,1327712970,1327738506,23243,25536
11461,1327307338,1327307349,1327739091,11,431742
11545,1327574693,1327574699,1327740030,6,165331
11562,1327576947,1327598699,1327743453,21752,144754
11656,1327765672,1327765680,1327781180,8,15500
11667,1327768828,1327768830,1327782089,2,13259
11669,1327768843,1327768845,1327782143,2,13298
11657,1327768493,1327768500,1327782588,7,14088
11662,1327768815,1327768830,1327783090,15,14260
11660,1327768810,1327768815,1327787528,5,18713
11666,1327768825,1327768830,1327788404,5,19574
11659,1327768762,1327768770,1327794690,8,25920
11673,1327768855,1327768860,1327795015,5,26155
11675,1327768860,1327781205,1327800878,12345,19673
11679,1327768881,1327783140,1327802401,14259,19261
11658,1327768752,1327768755,1327806972,3,38217
11663,1327768818,1327768830,1327807137,12,38307
11661,1327768813,1327768815,1327807147,2,38332
11665,1327768823,1327768830,1327807550,7,38720
11678,1327768875,1327782630,1327809027,13755,26397
11681,1327768886,1327788420,1327809203,19534,20783
11671,1327768849,1327768860,1327812599,11,43739
11676,1327768866,1327782120,1327815497,13254,33377
11623,1327666313,1327689990,1327816309,23677,126319
11654,1327704932,1327704953,1327818174,21,113221
11672,1327768852,1327768860,1327820028,8,51168
11686,1327829188,1327829190,1327829190,2,0
11684,1327818183,1327818199,1327833427,16,15228
11677,1327768870,1327782165,1327833749,13295,51584
11680,1327768884,1327787550,1327840393,18666,52843
11696,1327829219,1327829220,1327842502,1,13282
11691,1327829201,1327829205,1327843157,4,13952
11695,1327829212,1327829220,1327843584,8,14364
11698,1327829225,1327833780,1327844661,4555,10881
11689,1327829196,1327829205,1327844953,9,15748
11683,1327770367,1327795065,1327847847,24698,52782
11682,1327768889,1327794720,1327848236,25831,53516
11688,1327829193,1327829205,1327850199,12,20994
11697,1327829222,1327829265,1327851358,43,22093
11690,1327829199,1327829205,1327854752,6,25547
11692,1327829204,1327829205,1327857096,1,27891
11694,1327829209,1327829220,1327857459,11,28239
11693,1327829206,1327829220,1327859228,14,30008
11703,1327829240,1327844700,1327861118,15460,16418
11687,1327829191,1327829205,1327861557,14,32352
11702,1327829237,1327843620,1327861884,14383,18264
11685,1327828350,1327828365,1327863051,15,34686
11705,1327829251,1327847865,1327868594,18614,20729
11699,1327829229,1327840440,1327869689,11211,29249
11715,1327871674,1327871686,1327873392,12,1706
11718,1327873959,1327873966,1327875138,7,1172
11710,1327829280,1327857105,1327875995,27825,18890
11712,1327829285,1327859235,1327876073,29950,16838
11674,1327768857,1327768860,1327876085,3,107225
11709,1327829278,1327854795,1327876753,25517,21958
11704,1327829248,1327845000,1327882022,15752,37022
11719,1327875014,1327875017,1327882948,3,7931
11706,1327829255,1327848285,1327884854,19030,36569
11700,1327829232,1327842510,1327884946,13278,42436
11701,1327829234,1327843185,1327887892,13951,44707
11717,1327873779,1327873787,1327890515,8,16728
11711,1327829282,1327857480,1327892216,28198,34736
11714,1327829387,1327861605,1327893598,32218,31993
11716,1327872966,1327872983,1327894425,17,21442
11713,1327829287,1327861140,1327895796,31853,34656
11515,1327499314,1327499324,1327899617,10,400293
11723,1327899556,1327899576,1327899587,20,11
11720,1327883577,1327883582,1327905600,5,22018
11725,1327902354,1327905663,1327905670,3309,7
11708,1327829274,1327851375,1327906082,22101,54707
11724,1327900227,1327900235,1327906315,8,6080
11707,1327829259,1327850220,1327907971,20961,57751
11726,1327903719,1327905751,1327909211,2032,3460
11722,1327897451,1327897458,1327912749,7,15291
11729,1327913552,1327913565,1327913648,13,83
11730,1327913631,1327913640,1327913685,9,45
11731,1327913931,1327913940,1327914026,9,86
11737,1327916114,1327916115,1327916276,1,161
11740,1327917788,1327917795,1327917806,7,11
11747,1327919468,1327919475,1327919478,7,3
11727,1327910152,1327910160,1327919582,8,9422
11728,1327910158,1327910160,1327919600,2,9440
11569,1327579197,1327618544,1327920268,39347,301724
11721,1327897346,1327897353,1327920242,7,22889
11748,1327919474,1327919476,1327921954,2,2478
11771,1327920304,1327920315,1327924365,11,4050
11670,1327768846,1327768860,1327927373,14,158513
11757,1327919735,1327919748,1327929428,13,9680
11756,1327919709,1327920330,1327933444,621,13114
11738,1327917695,1327917705,1327934868,10,17163
11772,1327929962,1327929975,1327935076,13,5101
11753,1327919563,1327919640,1327935569,77,15929
11751,1327919557,1327919565,1327936472,8,16907
11755,1327919659,1327920330,1327937367,671,17037
11733,1327914014,1327914015,1327938217,1,24202
11762,1327920198,1327922025,1327938367,1827,16342
11750,1327919554,1327919565,1327939581,11,20016
11780,1327948809,1327948810,1327948810,1,0
11781,1327948914,1327948915,1327948915,1,0
11782,1327948963,1327948964,1327948964,1,0
11783,1327949020,1327949021,1327949021,1,0
11784,1327949148,1327949148,1327949148,0,0
11760,1327920191,1327920330,1327949946,139,29616
11785,1327951360,1327951361,1327951361,1,0
11787,1327951558,1327951558,1327951558,0,0
11786,1327951527,1327951528,1327951528,1,0
11752,1327919560,1327919595,1327952227,35,32632
11761,1327920194,1327922025,1327956709,1831,34684
11763,1327920202,1327922025,1327956899,1823,34874
11749,1327919550,1327919565,1327958140,15,38575
11767,1327920215,1327936489,1327959378,16274,22889
11668,1327768830,1327768845,1327959635,15,190790
11754,1327919571,1327920315,1327959661,744,39346
11766,1327920212,1327935600,1327961752,15388,26152
11789,1327958570,1327958571,1327961881,1,3310
11769,1327920221,1327938258,1327964189,18037,25931
11746,1327918626,1327918637,1327966227,11,47590
11739,1327917733,1327917735,1327967345,2,49610
11790,1327970084,1327970085,1327972552,1,2467
11745,1327918425,1327918440,1327975620,15,57180
11758,1327920182,1327920330,1327978492,148,58162
11770,1327920226,1327938395,1327978971,18169,40576
11759,1327920185,1327920330,1327979096,145,58766
11788,1327958291,1327958296,1327979175,5,20879
11764,1327920207,1327927425,1327979687,7218,52262
11765,1327920209,1327933485,1327986015,13276,52530
11768,1327920218,1327937397,1327991259,17179,53862
11794,1328000478,1328000478,1328000478,0,0
11795,1328000527,1328000528,1328000528,1,0
11796,1328000562,1328000562,1328000562,0,0
11797,1328000705,1328000705,1328000705,0,0
11798,1328000749,1328000749,1328000749,0,0
11799,1328000780,1328000781,1328000781,1,0
11800,1328000855,1328000855,1328000855,0,0
11801,1328000894,1328000894,1328000894,0,0
11802,1328000937,1328000938,1328000938,1,0
11803,1328000984,1328000985,1328000985,1,0
11804,1328001030,1328001030,1328001030,0,0
11805,1328001072,1328001073,1328001073,1,0
11806,1328001131,1328001131,1328001131,0,0
11807,1328001215,1328001216,1328001216,1,0
11808,1328001266,1328001266,1328001266,0,0
11812,1328003764,1328003765,1328003864,1,99
11741,1327917827,1327917840,1328004492,13,86652
11791,1327982362,1327982365,1328005630,3,23265
11792,1327982556,1327982558,1328006356,2,23798
11793,1327982667,1327982670,1328006811,3,24141
